file	n_pages_livestock	n_pages_sheep	n_pages_cattle	n_pages_trampl	n_pages_graz	n_pages_sedi	n_pages_qual	n_hits	n_pages
/datadrive/data/ESAdocs/federal_register/02-13342.pdf	10	3	3	0	28	0	0	44	29
/datadrive/data/ESAdocs/federal_register/02-23645.pdf	0	0	0	0	1	0	0	1	3
/datadrive/data/ESAdocs/federal_register/02-29778.pdf	0	0	1	0	2	0	1	4	2
/datadrive/data/ESAdocs/federal_register/02-849.pdf	0	0	0	0	1	0	0	1	1
/datadrive/data/ESAdocs/federal_register/03-22225.pdf	1	0	0	0	5	0	0	6	5
/datadrive/data/ESAdocs/federal_register/04-11036.pdf	0	0	0	0	1	0	0	1	2
/datadrive/data/ESAdocs/federal_register/04-14795.pdf	0	0	0	0	11	0	0	11	11
/datadrive/data/ESAdocs/federal_register/05-16569.pdf	0	0	0	0	1	0	0	1	2
/datadrive/data/ESAdocs/federal_register/05-4278.pdf	0	0	0	0	15	0	1	16	15
/datadrive/data/ESAdocs/federal_register/06-3344.pdf	16	1	5	2	54	5	4	87	104
/datadrive/data/ESAdocs/federal_register/2010-24730.pdf	0	0	0	0	2	1	0	3	3
/datadrive/data/ESAdocs/federal_register/2010-25044.pdf	0	0	0	0	7	0	0	7	8
/datadrive/data/ESAdocs/federal_register/2010-26764.pdf	0	0	0	0	7	2	0	9	10
/datadrive/data/ESAdocs/federal_register/2010-27773.pdf	0	0	0	0	4	0	0	4	6
/datadrive/data/ESAdocs/federal_register/2010-28272.pdf	0	0	0	0	3	0	1	4	3
/datadrive/data/ESAdocs/federal_register/2010-32628.pdf#page=1.pdf	5	0	1	0	20	1	0	27	23
/datadrive/data/ESAdocs/federal_register/2011-10288.pdf	0	0	0	0	2	0	0	2	6
/datadrive/data/ESAdocs/federal_register/2011-10467.pdf	5	3	0	1	18	0	0	27	19
/datadrive/data/ESAdocs/federal_register/2011-10753.pdf	14	0	0	8	21	1	0	44	33
/datadrive/data/ESAdocs/federal_register/2011-11607.pdf	0	0	0	0	1	0	0	1	4
/datadrive/data/ESAdocs/federal_register/2011-12330.pdf	2	0	0	0	17	0	1	20	23
/datadrive/data/ESAdocs/federal_register/2011-12928.pdf	0	0	0	0	18	0	0	18	24
/datadrive/data/ESAdocs/federal_register/2011-13044.pdf	0	0	0	0	2	0	0	2	2
/datadrive/data/ESAdocs/federal_register/2011-13224.pdf	0	1	2	0	10	0	0	13	13
/datadrive/data/ESAdocs/federal_register/2011-13227.pdf	3	0	0	0	20	4	2	29	30
/datadrive/data/ESAdocs/federal_register/2011-13381.pdf	0	0	1	0	15	3	6	25	39
/datadrive/data/ESAdocs/federal_register/2011-13684.pdf	2	0	1	0	12	0	0	15	15
/datadrive/data/ESAdocs/federal_register/2011-13687.pdf	0	0	0	0	8	3	4	15	9
/datadrive/data/ESAdocs/federal_register/2011-13910.pdf	5	5	5	14	40	0	0	69	43
/datadrive/data/ESAdocs/federal_register/2011-13911.pdf	0	1	0	0	14	0	0	15	19
/datadrive/data/ESAdocs/federal_register/2011-14212.pdf	0	0	0	0	2	0	0	2	3
/datadrive/data/ESAdocs/federal_register/2011-15183.pdf	0	0	0	0	2	0	0	2	3
/datadrive/data/ESAdocs/federal_register/2011-15283.pdf	6	0	0	0	13	0	0	19	16
/datadrive/data/ESAdocs/federal_register/2011-15355.pdf	0	0	0	0	2	0	0	2	3
/datadrive/data/ESAdocs/federal_register/2011-15370.pdf	1	0	0	0	16	0	3	20	17
/datadrive/data/ESAdocs/federal_register/2011-15403.pdf	1	0	0	0	4	0	0	5	4
/datadrive/data/ESAdocs/federal_register/2011-15603.pdf	0	0	0	0	11	0	0	11	16
/datadrive/data/ESAdocs/federal_register/2011-15975.pdf	0	0	0	0	1	0	0	1	2
/datadrive/data/ESAdocs/federal_register/2011-16016.pdf	0	0	0	0	13	8	7	28	15
/datadrive/data/ESAdocs/federal_register/2011-16344.pdf	0	0	0	0	7	0	0	7	12
/datadrive/data/ESAdocs/federal_register/2011-16379.pdf	0	0	0	0	2	0	0	2	2
/datadrive/data/ESAdocs/federal_register/2011-16748.pdf	0	0	0	0	1	0	0	1	2
/datadrive/data/ESAdocs/federal_register/2011-16982.pdf	1	0	0	0	3	0	0	4	4
/datadrive/data/ESAdocs/federal_register/2011-1703.pdf	7	0	1	3	76	9	5	101	223
/datadrive/data/ESAdocs/federal_register/2011-17162.pdf	3	0	7	11	108	3	1	133	234
/datadrive/data/ESAdocs/federal_register/2011-17452.pdf	0	0	0	0	2	0	0	2	3
/datadrive/data/ESAdocs/federal_register/2011-17943.pdf	0	1	0	0	19	0	0	20	24
/datadrive/data/ESAdocs/federal_register/2011-18428.pdf	9	0	0	0	37	0	1	47	52
/datadrive/data/ESAdocs/federal_register/2011-18429.pdf	8	0	3	8	20	0	0	39	23
/datadrive/data/ESAdocs/federal_register/2011-18561.pdf	0	0	0	0	6	0	0	6	8
/datadrive/data/ESAdocs/federal_register/2011-18856.pdf	0	1	0	0	31	0	0	32	34
/datadrive/data/ESAdocs/federal_register/2011-18893.pdf	0	0	0	0	3	0	0	3	3
/datadrive/data/ESAdocs/federal_register/2011-19222.pdf	0	0	0	0	1	0	0	1	5
/datadrive/data/ESAdocs/federal_register/2011-19444.pdf	4	0	4	2	13	1	4	28	17
/datadrive/data/ESAdocs/federal_register/2011-19532.pdf	1	0	1	0	27	0	0	29	36
/datadrive/data/ESAdocs/federal_register/2011-19676.pdf	0	0	0	0	3	0	1	4	7
/datadrive/data/ESAdocs/federal_register/2011-19713.pdf	7	0	5	0	54	3	1	70	89
/datadrive/data/ESAdocs/federal_register/2011-19812.pdf	0	0	0	2	24	0	0	26	27
/datadrive/data/ESAdocs/federal_register/2011-19818.pdf	0	0	0	1	2	0	0	3	5
/datadrive/data/ESAdocs/federal_register/2011-19895.pdf	0	0	0	0	2	0	0	2	2
/datadrive/data/ESAdocs/federal_register/2011-19953.pdf	9	3	5	0	27	1	0	45	30
/datadrive/data/ESAdocs/federal_register/2011-20018.pdf	2	0	2	2	18	10	11	45	20
/datadrive/data/ESAdocs/federal_register/2011-20137.pdf	1	0	0	0	1	0	0	2	1
/datadrive/data/ESAdocs/federal_register/2011-21201.pdf	0	0	0	0	1	0	0	1	3
/datadrive/data/ESAdocs/federal_register/2011-21425.pdf	0	0	0	0	1	0	0	1	2
/datadrive/data/ESAdocs/federal_register/2011-21442.pdf	0	0	0	0	17	8	1	26	32
/datadrive/data/ESAdocs/federal_register/2011-21556.pdf	0	0	0	0	15	0	0	15	16
/datadrive/data/ESAdocs/federal_register/2011-21614.pdf	0	0	0	0	3	0	0	3	3
/datadrive/data/ESAdocs/federal_register/2011-21839.pdf	0	0	0	0	3	0	0	3	3
/datadrive/data/ESAdocs/federal_register/2011-21879.pdf	0	0	0	0	2	0	0	2	2
/datadrive/data/ESAdocs/federal_register/2011-21945.pdf	1	0	0	0	21	0	3	25	28
/datadrive/data/ESAdocs/federal_register/2011-22372.pdf	0	0	0	0	2	0	0	2	3
/datadrive/data/ESAdocs/federal_register/2011-22433.pdf	0	2	5	4	27	0	0	38	35
/datadrive/data/ESAdocs/federal_register/2011-22900.pdf	0	0	0	0	3	0	0	3	4
/datadrive/data/ESAdocs/federal_register/2011-22990.pdf	0	0	0	6	10	0	0	16	16
/datadrive/data/ESAdocs/federal_register/2011-2367.pdf	3	0	1	0	17	0	1	22	17
/datadrive/data/ESAdocs/federal_register/2011-23911.pdf	0	0	0	0	1	0	0	1	2
/datadrive/data/ESAdocs/federal_register/2011-2400.pdf	0	1	0	12	32	5	1	51	47
/datadrive/data/ESAdocs/federal_register/2011-2403.pdf	0	1	2	2	44	0	1	50	79
/datadrive/data/ESAdocs/federal_register/2011-24045.pdf	4	0	2	0	7	1	1	15	15
/datadrive/data/ESAdocs/federal_register/2011-24046.pdf	0	0	0	0	23	2	5	30	30
/datadrive/data/ESAdocs/federal_register/2011-24047.pdf	0	3	1	0	34	2	3	43	46
/datadrive/data/ESAdocs/federal_register/2011-24519.pdf	3	0	2	0	24	15	16	60	49
/datadrive/data/ESAdocs/federal_register/2011-24608.pdf	0	0	0	0	4	0	0	4	7
/datadrive/data/ESAdocs/federal_register/2011-24633.pdf	1	3	4	2	22	9	5	46	28
/datadrive/data/ESAdocs/federal_register/2011-25083.pdf	0	0	2	0	4	1	0	7	10
/datadrive/data/ESAdocs/federal_register/2011-2529.pdf	1	1	6	0	15	0	0	23	21
/datadrive/data/ESAdocs/federal_register/2011-25359.pdf	18	3	2	0	41	0	0	64	43
/datadrive/data/ESAdocs/federal_register/2011-25471.pdf	2	2	1	4	41	26	14	90	48
/datadrive/data/ESAdocs/federal_register/2011-25483.pdf	0	0	0	0	1	0	0	1	1
/datadrive/data/ESAdocs/federal_register/2011-25539.pdf	3	0	1	0	22	16	17	59	34
/datadrive/data/ESAdocs/federal_register/2011-25583.pdf	0	0	0	0	14	0	1	15	23
/datadrive/data/ESAdocs/federal_register/2011-25595.pdf	0	0	0	0	10	1	0	11	10
/datadrive/data/ESAdocs/federal_register/2011-25655.pdf	12	2	3	0	39	22	27	105	60
/datadrive/data/ESAdocs/federal_register/2011-25690.pdf	4	0	1	0	16	7	10	38	23
/datadrive/data/ESAdocs/federal_register/2011-25808.pdf	2	1	1	0	16	0	0	20	19
/datadrive/data/ESAdocs/federal_register/2011-25809.pdf	0	0	1	0	16	4	7	28	24
/datadrive/data/ESAdocs/federal_register/2011-25811.pdf	0	0	2	0	12	0	0	14	15
/datadrive/data/ESAdocs/federal_register/2011-25818.pdf	0	1	0	0	33	1	0	35	44
/datadrive/data/ESAdocs/federal_register/2011-26301.pdf	0	0	5	0	52	7	6	70	66
/datadrive/data/ESAdocs/federal_register/2011-26798.pdf	0	0	0	0	3	0	1	4	3
/datadrive/data/ESAdocs/federal_register/2011-2691.pdf	0	0	0	0	2	1	0	3	2
/datadrive/data/ESAdocs/federal_register/2011-27122.pdf	14	4	9	8	59	7	7	108	71
/datadrive/data/ESAdocs/federal_register/2011-27644.pdf	0	0	0	0	3	0	0	3	6
/datadrive/data/ESAdocs/federal_register/2011-27727.pdf	1	0	0	1	3	0	0	5	6
/datadrive/data/ESAdocs/federal_register/2011-28065.pdf	0	0	0	0	2	0	0	2	2
/datadrive/data/ESAdocs/federal_register/2011-28126.pdf	0	0	0	0	1	0	0	1	1
/datadrive/data/ESAdocs/federal_register/2011-2882.pdf	0	0	0	0	0	0	0	0	3
/datadrive/data/ESAdocs/federal_register/2011-29780.pdf	1	0	1	0	4	0	0	6	7
/datadrive/data/ESAdocs/federal_register/2011-3038.pdf	3	0	0	0	36	3	1	43	67
/datadrive/data/ESAdocs/federal_register/2011-30451.pdf	0	0	0	0	17	0	1	18	21
/datadrive/data/ESAdocs/federal_register/2011-31427.pdf	0	0	1	0	3	0	0	4	3
/datadrive/data/ESAdocs/federal_register/2011-32431.pdf	0	0	0	0	8	0	1	9	9
/datadrive/data/ESAdocs/federal_register/2011-32825.pdf	19	1	2	0	52	0	0	74	62
/datadrive/data/ESAdocs/federal_register/2011-33602.pdf	4	1	9	0	31	1	0	46	33
/datadrive/data/ESAdocs/federal_register/2011-33610.pdf	5	0	1	0	7	0	0	13	8
/datadrive/data/ESAdocs/federal_register/2011-3730.pdf	0	2	0	0	8	1	0	11	12
/datadrive/data/ESAdocs/federal_register/2011-3732.pdf	1	0	0	0	10	0	0	11	12
/datadrive/data/ESAdocs/federal_register/2011-4036.pdf	0	0	0	0	14	2	1	17	26
/datadrive/data/ESAdocs/federal_register/2011-468.pdf	0	0	0	0	3	0	1	4	5
/datadrive/data/ESAdocs/federal_register/2011-469.pdf	2	24	1	1	19	10	6	63	30
/datadrive/data/ESAdocs/federal_register/2011-4884.pdf	1	1	0	1	16	0	0	19	17
/datadrive/data/ESAdocs/federal_register/2011-4906.pdf	0	0	0	1	56	1	1	59	121
/datadrive/data/ESAdocs/federal_register/2011-4997.pdf	19	0	6	1	38	7	3	74	83
/datadrive/data/ESAdocs/federal_register/2011-6347.pdf	0	1	1	0	12	3	6	23	14
/datadrive/data/ESAdocs/federal_register/2011-6638.pdf	0	0	0	0	2	0	0	2	2
/datadrive/data/ESAdocs/federal_register/2011-7238.pdf	0	0	0	0	6	0	2	8	6
/datadrive/data/ESAdocs/federal_register/2011-7668.pdf	0	0	0	0	15	7	8	30	17
/datadrive/data/ESAdocs/federal_register/2011-7691.pdf	0	0	1	0	6	1	4	12	6
/datadrive/data/ESAdocs/federal_register/2011-7827.pdf	0	1	0	0	13	1	0	15	18
/datadrive/data/ESAdocs/federal_register/2011-8176.pdf	2	0	2	1	19	3	4	31	26
/datadrive/data/ESAdocs/federal_register/2011-8822.pdf	0	0	0	0	5	0	0	5	10
/datadrive/data/ESAdocs/federal_register/2011-9542.pdf	0	0	0	0	2	0	0	2	2
/datadrive/data/ESAdocs/federal_register/2011-9557.pdf	17	2	2	0	54	0	0	75	61
/datadrive/data/ESAdocs/federal_register/2011-9864.pdf	1	0	0	0	2	0	0	3	2
/datadrive/data/ESAdocs/federal_register/2011-9973.pdf	5	0	1	1	10	6	3	26	10
/datadrive/data/ESAdocs/federal_register/2012-10033.pdf	0	0	0	0	1	0	0	1	1
/datadrive/data/ESAdocs/federal_register/2012-10212.pdf	0	3	0	0	3	0	0	6	5
/datadrive/data/ESAdocs/federal_register/2012-10407.pdf	2	0	0	0	4	0	0	6	5
/datadrive/data/ESAdocs/federal_register/2012-1043.pdf	1	3	4	1	8	0	0	17	10
/datadrive/data/ESAdocs/federal_register/2012-10451.pdf	0	0	0	0	1	0	0	1	2
/datadrive/data/ESAdocs/federal_register/2012-10635.pdf	1	1	8	0	14	0	0	24	22
/datadrive/data/ESAdocs/federal_register/2012-11059.pdf	0	0	0	0	0	0	0	0	3
/datadrive/data/ESAdocs/federal_register/2012-11100.pdf	6	0	0	5	31	4	1	47	38
/datadrive/data/ESAdocs/federal_register/2012-11229.pdf	2	1	1	1	14	7	6	32	18
/datadrive/data/ESAdocs/federal_register/2012-11339.pdf	0	3	3	8	39	0	0	53	52
/datadrive/data/ESAdocs/federal_register/2012-1147.pdf	0	0	0	0	3	0	0	3	4
/datadrive/data/ESAdocs/federal_register/2012-11484.pdf	4	6	15	15	118	0	1	159	313
/datadrive/data/ESAdocs/federal_register/2012-11671.pdf	0	0	0	0	4	1	0	5	5
/datadrive/data/ESAdocs/federal_register/2012-12572.pdf	0	0	0	0	2	0	1	3	5
/datadrive/data/ESAdocs/federal_register/2012-12867.pdf	0	0	0	0	3	0	0	3	6
/datadrive/data/ESAdocs/federal_register/2012-13305.pdf	0	0	0	0	7	0	0	7	11
/datadrive/data/ESAdocs/federal_register/2012-13421.pdf	0	0	0	0	3	0	0	3	4
/datadrive/data/ESAdocs/federal_register/2012-13425.pdf	0	0	0	0	3	0	0	3	6
/datadrive/data/ESAdocs/federal_register/2012-13488.pdf	0	0	1	0	30	2	5	38	45
/datadrive/data/ESAdocs/federal_register/2012-13886.pdf	0	0	1	1	76	2	3	83	143
/datadrive/data/ESAdocs/federal_register/2012-14733.pdf	0	0	0	0	2	0	0	2	4
/datadrive/data/ESAdocs/federal_register/2012-14853.pdf	0	0	0	0	3	0	0	3	3
/datadrive/data/ESAdocs/federal_register/2012-16445.pdf	1	0	4	1	23	0	0	29	27
/datadrive/data/ESAdocs/federal_register/2012-16461.pdf	1	0	9	3	17	0	0	30	19
/datadrive/data/ESAdocs/federal_register/2012-16479.pdf	0	2	2	0	18	0	2	24	29
/datadrive/data/ESAdocs/federal_register/2012-16492.pdf	4	0	10	0	45	3	0	62	49
/datadrive/data/ESAdocs/federal_register/2012-16988.pdf	8	0	3	2	18	1	3	35	19
/datadrive/data/ESAdocs/federal_register/2012-17402.pdf	3	3	5	2	34	4	2	53	35
/datadrive/data/ESAdocs/federal_register/2012-17939.pdf	2	0	2	0	5	0	0	9	6
/datadrive/data/ESAdocs/federal_register/2012-17950.pdf	1	0	0	0	30	15	15	61	35
/datadrive/data/ESAdocs/federal_register/2012-18198.pdf	1	0	1	0	3	0	1	6	4
/datadrive/data/ESAdocs/federal_register/2012-18211.pdf	0	0	0	0	16	0	0	16	25
/datadrive/data/ESAdocs/federal_register/2012-18284.pdf	2	0	1	0	18	0	0	21	27
/datadrive/data/ESAdocs/federal_register/2012-18768.pdf	0	0	0	0	4	0	0	4	4
/datadrive/data/ESAdocs/federal_register/2012-1914.pdf	0	0	0	0	1	0	0	1	2
/datadrive/data/ESAdocs/federal_register/2012-1950.pdf	0	1	0	0	61	11	34	107	70
/datadrive/data/ESAdocs/federal_register/2012-19561.pdf	2	1	2	10	108	2	2	127	216
/datadrive/data/ESAdocs/federal_register/2012-19659.pdf	10	0	3	1	63	30	37	144	88
/datadrive/data/ESAdocs/federal_register/2012-19829.pdf	4	2	1	0	38	4	7	56	51
/datadrive/data/ESAdocs/federal_register/2012-19950.pdf	3	0	3	0	22	0	1	29	30
/datadrive/data/ESAdocs/federal_register/2012-20086.pdf	11	0	0	4	23	1	1	40	27
/datadrive/data/ESAdocs/federal_register/2012-21742.pdf	0	0	0	3	12	0	0	15	17
/datadrive/data/ESAdocs/federal_register/2012-2195.pdf	3	0	0	0	44	3	4	54	75
/datadrive/data/ESAdocs/federal_register/2012-21988.pdf	32	5	3	0	73	0	1	114	76
/datadrive/data/ESAdocs/federal_register/2012-22033.pdf	0	0	0	0	5	0	0	5	6
/datadrive/data/ESAdocs/federal_register/2012-22061.pdf	6	0	11	8	43	7	3	78	60
/datadrive/data/ESAdocs/federal_register/2012-22657.pdf	0	0	0	0	2	0	0	2	2
/datadrive/data/ESAdocs/federal_register/2012-23019.pdf	0	0	0	0	2	0	0	2	3
/datadrive/data/ESAdocs/federal_register/2012-23747.pdf	1	0	0	1	16	0	0	18	24
/datadrive/data/ESAdocs/federal_register/2012-23843.pdf	0	0	0	1	29	0	0	30	40
/datadrive/data/ESAdocs/federal_register/2012-23853.pdf	24	2	11	9	61	1	1	109	71
/datadrive/data/ESAdocs/federal_register/2012-23854.pdf	5	0	3	1	20	8	17	54	28
/datadrive/data/ESAdocs/federal_register/2012-23999.pdf	0	0	1	0	18	4	9	32	26
/datadrive/data/ESAdocs/federal_register/2012-23.pdf	1	2	0	0	7	0	0	10	8
/datadrive/data/ESAdocs/federal_register/2012-24019.pdf	8	4	1	0	42	18	18	91	80
/datadrive/data/ESAdocs/federal_register/2012-24161.pdf	3	0	1	0	36	19	20	79	57
/datadrive/data/ESAdocs/federal_register/2012-24300.pdf	0	0	0	0	24	1	0	25	28
/datadrive/data/ESAdocs/federal_register/2012-24465.pdf	1	0	1	6	70	0	2	80	122
/datadrive/data/ESAdocs/federal_register/2012-24466.pdf	0	0	0	3	29	5	1	38	60
/datadrive/data/ESAdocs/federal_register/2012-24468.pdf	14	2	5	0	41	21	34	117	66
/datadrive/data/ESAdocs/federal_register/2012-24550.pdf	3	10	13	13	63	11	5	118	92
/datadrive/data/ESAdocs/federal_register/2012-24594.pdf	0	0	0	0	3	0	0	3	3
/datadrive/data/ESAdocs/federal_register/2012-25578.pdf	0	0	0	0	16	2	5	23	29
/datadrive/data/ESAdocs/federal_register/2012-27310.pdf	0	0	0	0	2	0	0	2	2
/datadrive/data/ESAdocs/federal_register/2012-28050.pdf	9	4	10	5	59	8	6	101	68
/datadrive/data/ESAdocs/federal_register/2012-28250.pdf	5	0	7	2	48	4	3	69	72
/datadrive/data/ESAdocs/federal_register/2012-28310.pdf	2	0	1	0	6	0	0	9	7
/datadrive/data/ESAdocs/federal_register/2012-28512.pdf	0	0	1	0	36	0	2	39	42
/datadrive/data/ESAdocs/federal_register/2012-28629.pdf	0	0	0	0	2	0	0	2	2
/datadrive/data/ESAdocs/federal_register/2012-28714.pdf	1	0	1	0	152	2	11	167	194
/datadrive/data/ESAdocs/federal_register/2012-30348.pdf	0	0	0	0	2	0	0	2	2
/datadrive/data/ESAdocs/federal_register/2012-30554.pdf	0	0	0	0	2	0	0	2	3
/datadrive/data/ESAdocs/federal_register/2012-30634.pdf	21	1	15	2	148	8	9	204	192
/datadrive/data/ESAdocs/federal_register/2012-30731.pdf	0	0	0	0	17	0	0	17	20
/datadrive/data/ESAdocs/federal_register/2012-30914.pdf	0	0	0	0	2	0	0	2	2
/datadrive/data/ESAdocs/federal_register/2012-31011.pdf	0	0	0	0	2	0	0	2	2
/datadrive/data/ESAdocs/federal_register/2012-31095.pdf	1	0	6	0	11	0	0	18	14
/datadrive/data/ESAdocs/federal_register/2012-31667.pdf	17	2	3	1	46	0	1	70	54
/datadrive/data/ESAdocs/federal_register/2012-31718.pdf	0	0	0	0	1	0	0	1	2
/datadrive/data/ESAdocs/federal_register/2012-3591.pdf	34	1	6	2	99	31	19	192	124
/datadrive/data/ESAdocs/federal_register/2012-3903.pdf	0	0	0	8	41	8	1	58	55
/datadrive/data/ESAdocs/federal_register/2012-4716.pdf	3	0	0	0	9	0	0	12	10
/datadrive/data/ESAdocs/federal_register/2012-5042.pdf	1	0	0	0	68	0	4	73	105
/datadrive/data/ESAdocs/federal_register/2012-5212.pdf	0	0	0	0	3	0	0	3	3
/datadrive/data/ESAdocs/federal_register/2012-521.pdf	0	0	0	0	10	0	0	10	12
/datadrive/data/ESAdocs/federal_register/2012-5335.pdf	0	0	0	0	3	0	0	3	4
/datadrive/data/ESAdocs/federal_register/2012-5603.pdf	3	32	1	1	26	15	10	88	37
/datadrive/data/ESAdocs/federal_register/2012-5953.pdf	28	0	8	2	51	7	4	100	102
/datadrive/data/ESAdocs/federal_register/2012-6055.pdf	0	0	0	0	16	0	0	16	19
/datadrive/data/ESAdocs/federal_register/2012-662.pdf	0	0	0	0	0	0	0	0	3
/datadrive/data/ESAdocs/federal_register/2012-6779.pdf	0	0	0	0	7	0	0	7	7
/datadrive/data/ESAdocs/federal_register/2012-6853.pdf	0	0	0	0	1	0	0	1	3
/datadrive/data/ESAdocs/federal_register/2012-7087.pdf	0	0	0	0	8	0	0	8	16
/datadrive/data/ESAdocs/federal_register/2012-7180.pdf	0	0	0	0	2	0	0	2	2
/datadrive/data/ESAdocs/federal_register/2012-7198.pdf	0	1	0	0	33	8	8	50	43
/datadrive/data/ESAdocs/federal_register/2012-7200.pdf	0	0	0	0	2	0	0	2	4
/datadrive/data/ESAdocs/federal_register/2012-8088.pdf	0	0	0	4	32	0	0	36	40
/datadrive/data/ESAdocs/federal_register/2012-8664.pdf	0	1	0	0	30	6	2	39	51
/datadrive/data/ESAdocs/federal_register/2012-8744.pdf	0	0	0	0	2	0	0	2	2
/datadrive/data/ESAdocs/federal_register/2012-8811.pdf	5	0	4	1	24	6	3	43	34
/datadrive/data/ESAdocs/federal_register/2012-926.pdf	0	0	0	0	2	0	1	3	2
/datadrive/data/ESAdocs/federal_register/2012-9403.pdf	0	0	0	0	15	0	0	15	18
/datadrive/data/ESAdocs/federal_register/2012-9884.pdf	1	0	0	0	6	0	0	7	10
/datadrive/data/ESAdocs/federal_register/2013-00291.pdf	0	0	5	0	10	0	0	15	11
/datadrive/data/ESAdocs/federal_register/2013-00692.pdf	1	0	1	0	10	0	0	12	12
/datadrive/data/ESAdocs/federal_register/2013-01155.pdf	0	0	0	0	1	0	0	1	2
/datadrive/data/ESAdocs/federal_register/2013-01292.pdf	0	0	0	0	2	0	0	2	2
/datadrive/data/ESAdocs/federal_register/2013-01293.pdf	0	0	0	0	2	0	0	2	2
/datadrive/data/ESAdocs/federal_register/2013-01302.pdf	4	0	1	1	16	7	3	32	19
/datadrive/data/ESAdocs/federal_register/2013-01303.pdf	6	1	1	1	16	7	2	34	17
/datadrive/data/ESAdocs/federal_register/2013-01307.pdf	1	0	0	0	6	1	2	10	19
/datadrive/data/ESAdocs/federal_register/2013-01478.pdf	3	0	0	0	25	0	0	28	28
/datadrive/data/ESAdocs/federal_register/2013-01479.pdf	2	0	0	0	13	0	0	15	16
/datadrive/data/ESAdocs/federal_register/2013-02051.pdf	0	0	0	0	2	0	0	2	5
/datadrive/data/ESAdocs/federal_register/2013-02057.pdf	4	0	9	2	62	9	6	92	75
/datadrive/data/ESAdocs/federal_register/2013-02453.pdf	0	0	0	0	2	0	0	2	3
/datadrive/data/ESAdocs/federal_register/2013-03109.pdf	0	1	0	0	30	7	2	40	49
/datadrive/data/ESAdocs/federal_register/2013-03111.pdf	2	0	0	0	5	0	0	7	7
/datadrive/data/ESAdocs/federal_register/2013-03136.pdf	0	0	1	0	20	0	0	21	23
/datadrive/data/ESAdocs/federal_register/2013-04046.pdf	0	0	0	0	2	0	0	2	2
/datadrive/data/ESAdocs/federal_register/2013-04785.pdf	0	0	0	0	5	0	0	5	15
/datadrive/data/ESAdocs/federal_register/2013-04888.pdf	2	0	0	0	3	0	0	5	4
/datadrive/data/ESAdocs/federal_register/2013-05237.pdf	0	0	0	0	2	0	0	2	2
/datadrive/data/ESAdocs/federal_register/2013-05504.pdf	0	0	2	0	16	0	0	18	18
/datadrive/data/ESAdocs/federal_register/2013-05997.pdf	0	0	0	0	2	0	1	3	2
/datadrive/data/ESAdocs/federal_register/2013-06458.pdf	0	0	0	0	34	2	1	37	84
/datadrive/data/ESAdocs/federal_register/2013-06612.pdf	0	0	0	0	2	0	0	2	2
/datadrive/data/ESAdocs/federal_register/2013-07122.pdf	2	0	1	0	4	0	0	7	5
/datadrive/data/ESAdocs/federal_register/2013-07159.pdf	2	0	0	0	4	0	0	6	6
/datadrive/data/ESAdocs/federal_register/2013-07306.pdf	0	1	0	0	5	0	2	8	5
/datadrive/data/ESAdocs/federal_register/2013-07495.pdf	0	0	0	0	5	0	0	5	5
/datadrive/data/ESAdocs/federal_register/2013-07792.pdf	0	0	0	0	8	0	0	8	13
/datadrive/data/ESAdocs/federal_register/2013-08364.pdf	0	0	0	0	24	2	1	27	34
/datadrive/data/ESAdocs/federal_register/2013-08815.pdf	0	0	0	0	2	0	2	4	2
/datadrive/data/ESAdocs/federal_register/2013-09241.pdf	0	0	0	0	3	0	0	3	4
/datadrive/data/ESAdocs/federal_register/2013-09404.pdf	1	0	0	5	22	2	1	31	26
/datadrive/data/ESAdocs/federal_register/2013-09409.pdf	5	0	0	1	21	2	0	29	23
/datadrive/data/ESAdocs/federal_register/2013-09494.pdf	0	0	0	0	2	0	0	2	2
/datadrive/data/ESAdocs/federal_register/2013-09598.pdf	3	0	0	0	31	2	10	46	60
/datadrive/data/ESAdocs/federal_register/2013-09600.pdf	14	4	5	7	37	4	2	73	44
/datadrive/data/ESAdocs/federal_register/2013-09884.pdf	0	0	0	0	1	0	0	1	2
/datadrive/data/ESAdocs/federal_register/2013-09895.pdf	0	0	0	0	4	0	1	5	7
/datadrive/data/ESAdocs/federal_register/2013-09975.pdf	0	0	0	0	1	0	1	2	4
/datadrive/data/ESAdocs/federal_register/2013-10044.pdf	1	0	0	0	6	0	0	7	9
/datadrive/data/ESAdocs/federal_register/2013-10492.pdf	0	0	0	0	1	0	0	1	1
/datadrive/data/ESAdocs/federal_register/2013-10497.pdf	0	0	0	0	7	0	0	7	7
/datadrive/data/ESAdocs/federal_register/2013-10705.pdf	0	0	0	0	5	0	0	5	6
/datadrive/data/ESAdocs/federal_register/2013-10990.pdf	0	0	1	0	5	0	1	7	7
/datadrive/data/ESAdocs/federal_register/2013-12050.pdf	0	0	0	0	2	0	0	2	3
/datadrive/data/ESAdocs/federal_register/2013-12102.pdf	0	0	0	0	13	2	1	16	20
/datadrive/data/ESAdocs/federal_register/2013-12103.pdf	0	0	1	1	13	1	0	16	14
/datadrive/data/ESAdocs/federal_register/2013-12379.pdf	0	0	0	0	0	0	0	0	3
/datadrive/data/ESAdocs/federal_register/2013-12380.pdf	0	0	0	0	1	0	0	1	1
/datadrive/data/ESAdocs/federal_register/2013-12387.pdf	5	0	4	1	29	3	4	46	34
/datadrive/data/ESAdocs/federal_register/2013-13098.pdf	1	0	0	2	17	2	1	23	19
/datadrive/data/ESAdocs/federal_register/2013-13268.pdf	0	0	0	0	6	0	0	6	8
/datadrive/data/ESAdocs/federal_register/2013-13725.pdf	0	0	0	7	56	3	1	67	65
/datadrive/data/ESAdocs/federal_register/2013-13977.pdf	16	3	2	0	20	0	0	41	24
/datadrive/data/ESAdocs/federal_register/2013-13982.pdf	19	4	1	0	56	0	0	80	57
/datadrive/data/ESAdocs/federal_register/2013-14007.pdf	0	0	0	0	16	0	0	16	17
/datadrive/data/ESAdocs/federal_register/2013-14365.pdf	1	0	0	0	6	0	0	7	7
/datadrive/data/ESAdocs/federal_register/2013-14366.pdf	8	1	1	0	24	2	1	37	37
/datadrive/data/ESAdocs/federal_register/2013-14425.pdf	1	0	0	0	1	0	0	2	2
/datadrive/data/ESAdocs/federal_register/2013-15006.pdf	4	1	7	0	27	1	0	40	30
/datadrive/data/ESAdocs/federal_register/2013-15487.pdf	0	0	0	0	9	1	0	10	15
/datadrive/data/ESAdocs/federal_register/2013-15531.pdf	0	0	0	0	1	0	0	1	3
/datadrive/data/ESAdocs/federal_register/2013-15628.pdf	0	0	0	0	2	0	0	2	4
/datadrive/data/ESAdocs/federal_register/2013-15688.pdf	1	0	1	0	10	0	0	12	14
/datadrive/data/ESAdocs/federal_register/2013-15746.pdf	0	0	0	0	2	0	0	2	3
/datadrive/data/ESAdocs/federal_register/2013-16032.pdf	0	0	0	0	2	0	0	2	2
/datadrive/data/ESAdocs/federal_register/2013-16111.pdf	0	0	0	0	2	0	0	2	3
/datadrive/data/ESAdocs/federal_register/2013-16222.pdf	4	1	1	0	23	4	7	40	32
/datadrive/data/ESAdocs/federal_register/2013-16230.pdf	0	0	0	0	20	1	1	22	27
/datadrive/data/ESAdocs/federal_register/2013-16239.pdf	0	0	0	0	1	0	0	1	5
/datadrive/data/ESAdocs/federal_register/2013-16240.pdf	4	0	1	0	8	0	0	13	14
/datadrive/data/ESAdocs/federal_register/2013-16520.pdf	5	1	0	0	39	13	4	62	60
/datadrive/data/ESAdocs/federal_register/2013-16521.pdf	12	0	3	3	39	10	1	68	49
/datadrive/data/ESAdocs/federal_register/2013-16812.pdf	0	0	0	0	1	0	0	1	2
/datadrive/data/ESAdocs/federal_register/2013-17087.pdf	0	0	2	0	11	1	2	16	17
/datadrive/data/ESAdocs/federal_register/2013-17089.pdf	0	1	1	5	27	0	0	34	35
/datadrive/data/ESAdocs/federal_register/2013-17197.pdf	0	0	0	0	1	0	0	1	2
/datadrive/data/ESAdocs/federal_register/2013-17205.pdf	0	0	0	0	3	0	0	3	7
/datadrive/data/ESAdocs/federal_register/2013-17938.pdf	0	0	0	0	21	14	14	49	22
/datadrive/data/ESAdocs/federal_register/2013-18211.pdf	1	0	0	0	8	0	2	11	9
/datadrive/data/ESAdocs/federal_register/2013-18212.pdf	0	0	0	0	15	3	10	28	24
/datadrive/data/ESAdocs/federal_register/2013-18213.pdf	4	0	2	1	25	1	0	33	26
/datadrive/data/ESAdocs/federal_register/2013-18456.pdf	3	0	1	1	26	2	2	35	50
/datadrive/data/ESAdocs/federal_register/2013-18579.pdf	6	0	1	2	9	0	0	18	9
/datadrive/data/ESAdocs/federal_register/2013-18583.pdf	5	0	0	0	17	0	1	23	28
/datadrive/data/ESAdocs/federal_register/2013-18823.pdf	0	0	0	0	3	0	0	3	3
/datadrive/data/ESAdocs/federal_register/2013-19385.pdf	6	0	0	2	15	1	1	25	19
/datadrive/data/ESAdocs/federal_register/2013-19386.pdf	9	0	0	3	14	0	0	26	17
/datadrive/data/ESAdocs/federal_register/2013-19632.pdf	1	0	2	1	16	0	0	20	19
/datadrive/data/ESAdocs/federal_register/2013-19705.pdf	0	0	0	0	2	0	1	3	3
/datadrive/data/ESAdocs/federal_register/2013-19713.pdf	2	0	1	0	36	6	12	57	53
/datadrive/data/ESAdocs/federal_register/2013-19715.pdf	5	0	0	0	41	26	35	107	50
/datadrive/data/ESAdocs/federal_register/2013-19793.pdf	0	0	0	0	18	0	1	19	48
/datadrive/data/ESAdocs/federal_register/2013-19794.pdf	0	0	0	0	15	1	0	16	24
/datadrive/data/ESAdocs/federal_register/2013-20190.pdf	0	0	0	0	0	0	0	0	1
/datadrive/data/ESAdocs/federal_register/2013-20449.pdf	1	0	0	0	20	10	15	46	25
/datadrive/data/ESAdocs/federal_register/2013-20671.pdf	0	0	0	0	1	0	0	1	2
/datadrive/data/ESAdocs/federal_register/2013-20965.pdf	0	0	0	0	1	0	0	1	2
/datadrive/data/ESAdocs/federal_register/2013-20985.pdf	2	0	1	0	18	1	3	25	43
/datadrive/data/ESAdocs/federal_register/2013-20986.pdf	9	0	10	5	37	8	15	84	43
/datadrive/data/ESAdocs/federal_register/2013-21168.pdf	0	0	0	0	1	0	0	1	2
/datadrive/data/ESAdocs/federal_register/2013-21313.pdf	0	0	0	0	8	0	0	8	11
/datadrive/data/ESAdocs/federal_register/2013-21376.pdf	0	0	0	0	3	0	0	3	4
/datadrive/data/ESAdocs/federal_register/2013-21583.pdf	5	0	1	1	22	0	0	29	29
/datadrive/data/ESAdocs/federal_register/2013-21664.pdf	0	0	0	0	2	0	0	2	3
/datadrive/data/ESAdocs/federal_register/2013-21665.pdf	0	0	0	0	2	0	0	2	2
/datadrive/data/ESAdocs/federal_register/2013-21718.pdf	0	0	0	0	2	0	0	2	2
/datadrive/data/ESAdocs/federal_register/2013-21809.pdf	3	0	1	1	4	0	0	9	6
/datadrive/data/ESAdocs/federal_register/2013-22083.pdf	1	0	5	3	29	6	1	45	50
/datadrive/data/ESAdocs/federal_register/2013-22085.pdf	6	0	6	10	40	8	2	72	45
/datadrive/data/ESAdocs/federal_register/2013-22128.pdf	1	0	0	0	13	0	1	15	36
/datadrive/data/ESAdocs/federal_register/2013-22129.pdf	0	0	0	0	7	0	0	7	10
/datadrive/data/ESAdocs/federal_register/2013-22132.pdf	0	0	0	0	6	0	0	6	8
/datadrive/data/ESAdocs/federal_register/2013-22245.pdf	4	0	0	1	18	13	7	43	22
/datadrive/data/ESAdocs/federal_register/2013-22700.pdf	1	1	2	2	71	20	2	99	76
/datadrive/data/ESAdocs/federal_register/2013-22702.pdf	1	0	0	1	14	0	0	16	27
/datadrive/data/ESAdocs/federal_register/2013-22706.pdf	3	0	1	0	8	0	1	13	8
/datadrive/data/ESAdocs/federal_register/2013-22742.pdf	0	0	2	0	17	1	0	20	20
/datadrive/data/ESAdocs/federal_register/2013-23124.pdf	18	2	10	7	42	0	0	79	46
/datadrive/data/ESAdocs/federal_register/2013-23182.pdf	2	0	0	0	13	3	7	25	16
/datadrive/data/ESAdocs/federal_register/2013-23185.pdf	6	0	0	0	16	9	12	43	18
/datadrive/data/ESAdocs/federal_register/2013-23189.pdf	1	0	0	0	34	0	1	36	46
/datadrive/data/ESAdocs/federal_register/2013-23356.pdf	2	0	1	0	14	10	7	34	19
/datadrive/data/ESAdocs/federal_register/2013-23357.pdf	7	4	0	0	30	7	13	61	66
/datadrive/data/ESAdocs/federal_register/2013-23401.pdf	0	0	0	0	31	1	0	32	41
/datadrive/data/ESAdocs/federal_register/2013-23410.pdf	0	0	0	0	0	0	0	0	1
/datadrive/data/ESAdocs/federal_register/2013-23552.pdf	2	0	0	2	56	0	1	61	85
/datadrive/data/ESAdocs/federal_register/2013-23567.pdf	6	0	1	5	46	0	2	60	53
/datadrive/data/ESAdocs/federal_register/2013-23725.pdf	9	0	2	2	42	4	1	60	46
/datadrive/data/ESAdocs/federal_register/2013-23726.pdf	4	0	4	1	14	6	11	40	18
/datadrive/data/ESAdocs/federal_register/2013-23753.pdf	0	0	0	0	23	0	1	24	36
/datadrive/data/ESAdocs/federal_register/2013-24103.pdf	1	10	22	14	40	19	5	111	54
/datadrive/data/ESAdocs/federal_register/2013-24104.pdf	0	0	0	0	2	0	0	2	3
/datadrive/data/ESAdocs/federal_register/2013-24168.pdf	0	0	0	0	14	2	8	24	28
/datadrive/data/ESAdocs/federal_register/2013-24169.pdf	0	0	0	0	25	1	1	27	32
/datadrive/data/ESAdocs/federal_register/2013-24173.pdf	0	0	0	1	19	0	0	20	21
/datadrive/data/ESAdocs/federal_register/2013-24174.pdf	0	0	0	0	18	0	1	19	28
/datadrive/data/ESAdocs/federal_register/2013-24177.pdf	0	0	0	2	20	1	0	23	27
/datadrive/data/ESAdocs/federal_register/2013-24778.pdf	7	0	2	0	34	0	1	44	121
/datadrive/data/ESAdocs/federal_register/2013-25070.pdf	1	0	10	0	39	0	0	50	43
/datadrive/data/ESAdocs/federal_register/2013-25390.pdf	0	0	0	0	2	0	0	2	2
/datadrive/data/ESAdocs/federal_register/2013-25397.pdf	0	0	0	2	28	1	0	31	33
/datadrive/data/ESAdocs/federal_register/2013-25399.pdf	0	0	0	2	17	1	1	21	21
/datadrive/data/ESAdocs/federal_register/2013-25849.pdf	0	0	0	0	2	0	0	2	2
/datadrive/data/ESAdocs/federal_register/2013-26122.pdf	1	0	0	2	15	0	0	18	16
/datadrive/data/ESAdocs/federal_register/2013-26332.pdf	0	0	0	0	3	0	0	3	3
/datadrive/data/ESAdocs/federal_register/2013-26366.pdf	0	0	0	0	4	0	1	5	4
/datadrive/data/ESAdocs/federal_register/2013-26465.pdf	0	0	0	0	1	0	1	2	3
/datadrive/data/ESAdocs/federal_register/2013-27297.pdf	0	0	0	0	2	0	0	2	3
/datadrive/data/ESAdocs/federal_register/2013-27391.pdf	4	2	9	8	49	6	7	85	60
/datadrive/data/ESAdocs/federal_register/2013-27584.pdf	0	0	0	0	2	0	0	2	2
/datadrive/data/ESAdocs/federal_register/2013-27736.pdf	5	0	0	1	20	0	1	27	23
/datadrive/data/ESAdocs/federal_register/2013-28705.pdf	0	0	0	0	0	0	0	0	2
/datadrive/data/ESAdocs/federal_register/2013-28879.pdf	6	3	1	0	13	0	0	23	13
/datadrive/data/ESAdocs/federal_register/2013-29410.pdf	0	0	0	0	7	0	0	7	9
/datadrive/data/ESAdocs/federal_register/2013-29587.pdf	1	0	0	0	8	0	0	9	8
/datadrive/data/ESAdocs/federal_register/2013-30164.pdf	0	0	0	0	7	0	0	7	11
/datadrive/data/ESAdocs/federal_register/2013-30481.pdf	0	0	0	0	2	0	0	2	2
/datadrive/data/ESAdocs/federal_register/2013-30750.pdf	0	0	0	0	1	0	0	1	2
/datadrive/data/ESAdocs/federal_register/2013-31575.pdf	0	0	0	0	4	0	1	5	5
/datadrive/data/ESAdocs/federal_register/2013-31576.pdf	0	0	0	1	14	3	1	19	40
/datadrive/data/ESAdocs/federal_register/2014-00034.pdf	0	0	0	0	0	0	2	2	3
/datadrive/data/ESAdocs/federal_register/2014-00164.pdf	0	0	0	0	5	1	0	6	5
/datadrive/data/ESAdocs/federal_register/2014-00281.pdf	0	0	0	0	5	0	0	5	6
/datadrive/data/ESAdocs/federal_register/2014-01145.pdf	0	0	0	0	2	0	0	2	3
/datadrive/data/ESAdocs/federal_register/2014-01271.pdf	0	1	0	0	3	0	0	4	4
/datadrive/data/ESAdocs/federal_register/2014-01786.pdf	0	0	0	0	3	0	0	3	3
/datadrive/data/ESAdocs/federal_register/2014-02362.pdf	0	0	0	0	1	0	0	1	2
/datadrive/data/ESAdocs/federal_register/2014-02415.pdf	0	0	0	0	3	0	0	3	4
/datadrive/data/ESAdocs/federal_register/2014-02779.pdf	1	0	0	0	2	0	0	3	2
/datadrive/data/ESAdocs/federal_register/2014-02817.pdf	0	0	0	0	2	0	0	2	3
/datadrive/data/ESAdocs/federal_register/2014-02982.pdf	0	0	1	0	3	0	0	4	4
/datadrive/data/ESAdocs/federal_register/2014-03120.pdf	1	0	0	0	4	0	0	5	10
/datadrive/data/ESAdocs/federal_register/2014-03133.pdf	0	0	0	0	12	1	0	13	13
/datadrive/data/ESAdocs/federal_register/2014-03134.pdf	0	0	0	0	5	0	0	5	12
/datadrive/data/ESAdocs/federal_register/2014-03451.pdf	0	0	0	0	2	0	0	2	2
/datadrive/data/ESAdocs/federal_register/2014-03485.pdf	12	0	10	0	69	0	1	92	84
/datadrive/data/ESAdocs/federal_register/2014-03717.pdf	9	0	2	1	52	23	44	131	59
/datadrive/data/ESAdocs/federal_register/2014-03719.pdf	0	0	0	0	4	0	1	5	4
/datadrive/data/ESAdocs/federal_register/2014-04138.pdf	0	0	0	0	2	0	0	2	2
/datadrive/data/ESAdocs/federal_register/2014-04232.pdf	0	0	0	1	21	0	0	22	21
/datadrive/data/ESAdocs/federal_register/2014-04465.pdf	0	0	0	0	2	0	0	2	5
/datadrive/data/ESAdocs/federal_register/2014-04586.pdf	0	0	0	0	2	0	0	2	2
/datadrive/data/ESAdocs/federal_register/2014-04698.pdf	0	0	0	0	1	0	0	1	2
/datadrive/data/ESAdocs/federal_register/2014-05335.pdf	0	0	2	0	21	4	10	37	24
/datadrive/data/ESAdocs/federal_register/2014-05445.pdf	1	0	0	0	4	0	0	5	6
/datadrive/data/ESAdocs/federal_register/2014-06502.pdf	0	0	0	0	3	0	0	3	3
/datadrive/data/ESAdocs/federal_register/2014-06665.pdf	6	0	1	3	18	8	3	39	20
/datadrive/data/ESAdocs/federal_register/2014-07298.pdf	1	0	0	0	10	0	0	11	13
/datadrive/data/ESAdocs/federal_register/2014-07302.pdf	21	0	10	1	93	0	1	126	99
/datadrive/data/ESAdocs/federal_register/2014-07411.pdf	0	0	0	0	2	0	0	2	2
/datadrive/data/ESAdocs/federal_register/2014-07414.pdf	3	0	0	0	30	0	0	33	38
/datadrive/data/ESAdocs/federal_register/2014-07415.pdf	2	0	1	0	36	0	1	40	47
/datadrive/data/ESAdocs/federal_register/2014-07629.pdf	2	0	1	0	5	0	0	8	7
/datadrive/data/ESAdocs/federal_register/2014-07986.pdf	0	0	0	0	2	0	0	2	2
/datadrive/data/ESAdocs/federal_register/2014-08193.pdf	0	0	0	0	2	0	0	2	2
/datadrive/data/ESAdocs/federal_register/2014-09018.pdf	0	0	0	0	2	0	0	2	3
/datadrive/data/ESAdocs/federal_register/2014-09019.pdf	0	0	0	0	2	0	0	2	2
/datadrive/data/ESAdocs/federal_register/2014-09488.pdf	27	4	8	9	47	6	3	104	56
/datadrive/data/ESAdocs/federal_register/2014-09601.pdf	0	0	0	0	26	0	0	26	33
/datadrive/data/ESAdocs/federal_register/2014-10049.pdf	0	0	0	0	6	0	0	6	6
/datadrive/data/ESAdocs/federal_register/2014-10050.pdf	0	0	0	0	12	2	1	15	19
/datadrive/data/ESAdocs/federal_register/2014-10051.pdf	2	0	0	2	22	2	1	29	26
/datadrive/data/ESAdocs/federal_register/2014-10052.pdf	0	0	1	0	7	0	0	8	9
/datadrive/data/ESAdocs/federal_register/2014-10053.pdf	0	0	0	0	5	0	0	5	10
/datadrive/data/ESAdocs/federal_register/2014-10181.pdf	0	0	0	0	1	0	0	1	2
/datadrive/data/ESAdocs/federal_register/2014-10337.pdf	0	0	0	0	2	0	0	2	3
/datadrive/data/ESAdocs/federal_register/2014-10399.pdf	0	0	0	0	3	0	0	3	6
/datadrive/data/ESAdocs/federal_register/2014-10506.pdf	2	0	3	0	13	0	0	18	14
/datadrive/data/ESAdocs/federal_register/2014-10533.pdf	0	0	0	0	4	0	1	5	10
/datadrive/data/ESAdocs/federal_register/2014-10873.pdf	0	0	0	0	1	0	0	1	3
/datadrive/data/ESAdocs/federal_register/2014-10944.pdf	0	0	0	0	1	0	0	1	2
/datadrive/data/ESAdocs/federal_register/2014-11537.pdf	0	0	0	0	3	0	0	3	3
/datadrive/data/ESAdocs/federal_register/2014-11730.pdf	1	0	0	0	1	0	0	2	2
/datadrive/data/ESAdocs/federal_register/2014-11731.pdf	0	0	0	0	2	0	0	2	5
/datadrive/data/ESAdocs/federal_register/2014-12501.pdf	0	0	0	0	4	0	0	4	8
/datadrive/data/ESAdocs/federal_register/2014-12627.pdf	3	0	1	2	6	0	0	12	6
/datadrive/data/ESAdocs/federal_register/2014-12629.pdf	7	0	0	1	22	0	1	31	31
/datadrive/data/ESAdocs/federal_register/2014-13094.pdf	8	0	5	1	19	2	0	35	19
/datadrive/data/ESAdocs/federal_register/2014-13426.pdf	0	0	0	0	0	0	0	0	2
/datadrive/data/ESAdocs/federal_register/2014-14184.pdf	0	0	0	0	5	0	0	5	12
/datadrive/data/ESAdocs/federal_register/2014-14615.pdf	21	0	1	2	55	15	1	95	70
/datadrive/data/ESAdocs/federal_register/2014-14624.pdf	1	0	1	0	23	0	0	25	32
/datadrive/data/ESAdocs/federal_register/2014-14761.pdf	0	0	0	0	18	0	0	18	27
/datadrive/data/ESAdocs/federal_register/2014-14812.pdf	0	0	0	0	2	0	0	2	3
/datadrive/data/ESAdocs/federal_register/2014-15213.pdf	0	0	0	0	1	0	0	1	2
/datadrive/data/ESAdocs/federal_register/2014-15383.pdf	0	0	0	0	0	0	0	0	1
/datadrive/data/ESAdocs/federal_register/2014-15458.pdf	0	0	0	0	4	0	0	4	5
/datadrive/data/ESAdocs/federal_register/2014-15725.pdf	0	0	0	0	47	5	1	53	100
/datadrive/data/ESAdocs/federal_register/2014-15867.pdf	0	0	0	0	3	0	0	3	3
/datadrive/data/ESAdocs/federal_register/2014-16164.pdf	0	0	0	0	6	0	0	6	15
/datadrive/data/ESAdocs/federal_register/2014-16355.pdf	0	0	0	2	17	0	1	20	21
/datadrive/data/ESAdocs/federal_register/2014-16756.pdf	0	0	0	0	3	0	0	3	10
/datadrive/data/ESAdocs/federal_register/2014-17205.pdf	12	1	1	1	26	11	3	55	31
/datadrive/data/ESAdocs/federal_register/2014-17587.pdf	10	5	3	0	14	0	0	32	16
/datadrive/data/ESAdocs/federal_register/2014-17692.pdf	1	0	2	0	13	0	7	23	14
/datadrive/data/ESAdocs/federal_register/2014-17694.pdf	1	0	1	0	17	2	10	31	31
/datadrive/data/ESAdocs/federal_register/2014-18103.pdf	0	0	0	0	5	0	0	5	7
/datadrive/data/ESAdocs/federal_register/2014-18611.pdf	0	0	0	0	14	0	1	15	42
/datadrive/data/ESAdocs/federal_register/2014-18614.pdf	0	0	0	0	14	1	0	15	24
/datadrive/data/ESAdocs/federal_register/2014-18743.pdf	1	0	0	0	21	0	0	22	25
/datadrive/data/ESAdocs/federal_register/2014-19178.pdf	8	0	1	0	57	5	1	72	106
/datadrive/data/ESAdocs/federal_register/2014-19558.pdf	3	0	1	1	27	2	1	35	51
/datadrive/data/ESAdocs/federal_register/2014-19560.pdf	0	0	0	0	1	0	0	1	3
/datadrive/data/ESAdocs/federal_register/2014-19590.pdf	0	0	0	0	1	0	0	1	2
/datadrive/data/ESAdocs/federal_register/2014-20059.pdf	13	0	12	6	45	10	21	107	54
/datadrive/data/ESAdocs/federal_register/2014-20463.pdf	0	0	0	0	1	0	0	1	3
/datadrive/data/ESAdocs/federal_register/2014-21013.pdf	1	0	1	0	48	0	1	51	66
/datadrive/data/ESAdocs/federal_register/2014-21026.pdf	0	0	0	0	3	0	0	3	3
/datadrive/data/ESAdocs/federal_register/2014-21078.pdf	0	0	0	0	1	0	0	1	3
/datadrive/data/ESAdocs/federal_register/2014-21110.pdf	0	0	0	1	9	0	0	10	9
/datadrive/data/ESAdocs/federal_register/2014-21230.pdf	0	0	0	0	0	0	0	0	1
/datadrive/data/ESAdocs/federal_register/2014-21231.pdf	0	0	2	0	11	0	0	13	13
/datadrive/data/ESAdocs/federal_register/2014-21232.pdf	0	0	0	0	24	1	1	26	30
/datadrive/data/ESAdocs/federal_register/2014-21380.pdf	1	0	0	0	12	0	1	14	33
/datadrive/data/ESAdocs/federal_register/2014-21394.pdf	0	0	0	0	8	0	0	8	9
/datadrive/data/ESAdocs/federal_register/2014-21549.pdf	0	0	0	0	2	0	0	2	2
/datadrive/data/ESAdocs/federal_register/2014-21585.pdf	2	0	0	0	35	0	1	38	45
/datadrive/data/ESAdocs/federal_register/2014-22577.pdf	2	0	0	0	7	0	0	9	27
/datadrive/data/ESAdocs/federal_register/2014-22594.pdf	0	0	0	0	3	0	0	3	3
/datadrive/data/ESAdocs/federal_register/2014-22776.pdf	0	0	8	7	38	1	1	55	51
/datadrive/data/ESAdocs/federal_register/2014-23640.pdf	10	0	3	2	44	4	1	64	48
/datadrive/data/ESAdocs/federal_register/2014-23671.pdf	9	5	1	0	15	0	0	30	15
/datadrive/data/ESAdocs/federal_register/2014-23673.pdf	0	0	0	0	13	0	0	13	14
/datadrive/data/ESAdocs/federal_register/2014-23686.pdf	1	0	3	0	18	1	0	23	27
/datadrive/data/ESAdocs/federal_register/2014-24548.pdf	0	0	0	0	0	0	0	0	2
/datadrive/data/ESAdocs/federal_register/2014-25190.pdf	14	0	8	2	74	0	0	98	78
/datadrive/data/ESAdocs/federal_register/2014-25731.pdf	13	2	9	0	26	0	0	50	32
/datadrive/data/ESAdocs/federal_register/2014-26362.pdf	0	0	0	0	2	0	0	2	2
/datadrive/data/ESAdocs/federal_register/2014-26685.pdf	0	0	0	0	1	0	0	1	2
/datadrive/data/ESAdocs/federal_register/2014-26893.pdf	0	0	0	0	2	0	0	2	4
/datadrive/data/ESAdocs/federal_register/2014-27109.pdf	34	2	11	3	108	0	1	159	120
/datadrive/data/ESAdocs/federal_register/2014-27113.pdf	8	0	2	0	40	0	1	51	53
/datadrive/data/ESAdocs/federal_register/2014-27407.pdf	0	0	0	0	1	0	0	1	3
/datadrive/data/ESAdocs/federal_register/2014-27757.pdf	0	0	0	0	2	0	0	2	2
/datadrive/data/ESAdocs/federal_register/2014-27872.pdf	0	0	0	0	1	0	0	1	2
/datadrive/data/ESAdocs/federal_register/2014-28330.pdf	0	0	0	0	1	0	0	1	3
/datadrive/data/ESAdocs/federal_register/2014-28338.pdf	0	0	0	0	40	3	0	43	44
/datadrive/data/ESAdocs/federal_register/2014-28536.pdf	4	2	5	5	42	5	3	66	49
/datadrive/data/ESAdocs/federal_register/2014-29123.pdf	0	0	0	0	2	0	0	2	2
/datadrive/data/ESAdocs/federal_register/2014-30574.pdf	0	0	0	0	3	0	0	3	4
/datadrive/data/ESAdocs/federal_register/2015-00259.pdf	0	0	0	0	1	0	0	1	2
/datadrive/data/ESAdocs/federal_register/2015-00344.pdf	0	0	0	1	19	4	1	25	64
/datadrive/data/ESAdocs/federal_register/2015-00392.pdf	0	0	0	0	2	0	0	2	2
/datadrive/data/ESAdocs/federal_register/2015-00414.pdf	0	0	0	0	3	0	1	4	3
/datadrive/data/ESAdocs/federal_register/2015-00441.pdf	6	2	0	0	25	0	0	33	26
/datadrive/data/ESAdocs/federal_register/2015-00644.pdf	0	0	0	0	5	0	1	6	8
/datadrive/data/ESAdocs/federal_register/2015-01348.pdf	0	0	0	0	1	0	0	1	3
/datadrive/data/ESAdocs/federal_register/2015-03015.pdf	0	0	0	0	3	0	0	3	4
/datadrive/data/ESAdocs/federal_register/2015-03503.pdf	5	3	2	0	12	0	0	22	12
/datadrive/data/ESAdocs/federal_register/2015-03504.pdf	0	0	0	0	2	0	0	2	2
/datadrive/data/ESAdocs/federal_register/2015-05326.pdf	0	0	0	0	16	0	1	17	30
/datadrive/data/ESAdocs/federal_register/2015-05330.pdf	0	0	0	0	1	0	0	1	2
/datadrive/data/ESAdocs/federal_register/2015-06136.pdf	0	0	0	1	56	8	4	69	67
/datadrive/data/ESAdocs/federal_register/2015-06302.pdf	0	0	0	0	2	0	0	2	2
/datadrive/data/ESAdocs/federal_register/2015-07069.pdf	0	0	0	0	41	0	2	43	61
/datadrive/data/ESAdocs/federal_register/2015-07625.pdf	1	0	0	0	24	16	12	53	31
/datadrive/data/ESAdocs/federal_register/2015-07837.pdf	0	0	0	0	2	0	0	2	5
/datadrive/data/ESAdocs/federal_register/2015-08093.pdf	0	0	0	0	7	1	6	14	7
/datadrive/data/ESAdocs/federal_register/2015-08271.pdf	2	0	0	0	11	0	0	13	13
/datadrive/data/ESAdocs/federal_register/2015-08277.pdf	0	0	0	0	6	0	0	6	13
/datadrive/data/ESAdocs/federal_register/2015-08624.pdf	0	0	0	0	3	0	0	3	3
/datadrive/data/ESAdocs/federal_register/2015-09010.pdf	0	0	0	0	44	0	1	45	54
/datadrive/data/ESAdocs/federal_register/2015-09200.pdf	5	0	0	0	29	13	16	63	84
/datadrive/data/ESAdocs/federal_register/2015-13136.pdf	0	0	0	0	5	1	1	7	7
/datadrive/data/ESAdocs/federal_register/2015-13479.pdf	0	0	0	0	5	0	0	5	6
/datadrive/data/ESAdocs/federal_register/2015-13624.pdf	0	0	0	0	3	0	0	3	3
/datadrive/data/ESAdocs/federal_register/2015-14232.pdf	0	0	0	0	21	0	0	21	27
/datadrive/data/ESAdocs/federal_register/2015-14906.pdf	0	0	0	0	1	0	0	1	2
/datadrive/data/ESAdocs/federal_register/2015-14931.pdf	1	0	0	0	6	0	0	7	11
/datadrive/data/ESAdocs/federal_register/2015-15212.pdf	0	0	0	0	7	0	0	7	10
/datadrive/data/ESAdocs/federal_register/2015-15947.pdf	0	0	0	2	20	0	1	23	28
/datadrive/data/ESAdocs/federal_register/2015-16001.pdf	0	0	0	0	8	0	0	8	12
/datadrive/data/ESAdocs/federal_register/2015-16249.pdf	0	0	0	0	2	0	0	2	2
/datadrive/data/ESAdocs/federal_register/2015-16595.pdf	0	0	0	0	1	0	1	2	2
/datadrive/data/ESAdocs/federal_register/2015-17409.pdf	0	0	0	0	2	0	0	2	2
/datadrive/data/ESAdocs/federal_register/2015-17705.pdf	0	0	0	0	2	0	1	3	2
/datadrive/data/ESAdocs/federal_register/2015-18246.pdf	0	0	0	0	0	0	0	0	1
/datadrive/data/ESAdocs/federal_register/2015-18487.pdf	0	0	0	0	18	0	0	18	27
/datadrive/data/ESAdocs/federal_register/2015-18602.pdf	1	0	5	0	11	0	0	17	12
/datadrive/data/ESAdocs/federal_register/2015-18671.pdf	0	0	0	0	2	0	0	2	2
/datadrive/data/ESAdocs/federal_register/2015-19335.pdf	1	0	0	1	10	1	9	22	11
/datadrive/data/ESAdocs/federal_register/2015-19352.pdf	0	0	1	1	20	1	0	23	29
/datadrive/data/ESAdocs/federal_register/2015-19533.pdf	0	0	0	0	17	0	1	18	42
/datadrive/data/ESAdocs/federal_register/2015-20617.pdf	0	0	1	0	33	0	4	38	64
/datadrive/data/ESAdocs/federal_register/2015-20837.pdf	0	0	0	0	13	0	1	14	18
/datadrive/data/ESAdocs/federal_register/2015-20846.pdf	0	0	0	0	2	0	0	2	2
/datadrive/data/ESAdocs/federal_register/2015-21150.pdf	0	0	0	0	2	0	0	2	2
/datadrive/data/ESAdocs/federal_register/2015-21410.pdf	0	0	0	5	13	0	0	18	16
/datadrive/data/ESAdocs/federal_register/2015-22973.pdf	0	0	0	0	15	0	0	15	18
/datadrive/data/ESAdocs/federal_register/2015-23315.pdf	0	0	0	0	3	0	0	3	10
/datadrive/data/ESAdocs/federal_register/2015-24184.pdf	9	0	2	0	58	0	1	70	138
/datadrive/data/ESAdocs/federal_register/2015-24291.pdf	0	0	0	0	24	3	0	27	33
/datadrive/data/ESAdocs/federal_register/2015-24305.pdf	4	16	30	10	75	9	2	146	91
/datadrive/data/ESAdocs/federal_register/2015-24443.pdf	1	0	10	14	54	1	1	81	75
/datadrive/data/ESAdocs/federal_register/2015-24775.pdf	2	0	0	0	14	0	1	17	15
/datadrive/data/ESAdocs/federal_register/2015-24780.pdf	0	0	0	0	11	0	0	11	14
/datadrive/data/ESAdocs/federal_register/2015-24820.pdf	4	0	9	0	41	2	0	56	47
/datadrive/data/ESAdocs/federal_register/2015-24900.pdf	1	0	0	0	27	2	1	31	31
/datadrive/data/ESAdocs/federal_register/2015-25216.pdf	0	0	0	0	3	0	0	3	3
/datadrive/data/ESAdocs/federal_register/2015-25260.pdf	2	1	2	1	18	0	1	25	22
/datadrive/data/ESAdocs/federal_register/2015-25270.pdf	0	0	0	0	20	0	1	21	23
/datadrive/data/ESAdocs/federal_register/2015-25278.pdf	1	0	0	0	22	13	11	47	28
/datadrive/data/ESAdocs/federal_register/2015-25280.pdf	2	0	0	0	10	7	7	26	14
/datadrive/data/ESAdocs/federal_register/2015-25289.pdf	0	0	0	0	29	0	0	29	40
/datadrive/data/ESAdocs/federal_register/2015-25290.pdf	2	0	0	0	23	5	8	38	53
/datadrive/data/ESAdocs/federal_register/2015-25298.pdf	0	0	2	2	35	0	0	39	41
/datadrive/data/ESAdocs/federal_register/2015-25299.pdf	1	0	3	0	19	1	0	24	27
/datadrive/data/ESAdocs/federal_register/2015-25977.pdf	0	0	0	0	1	0	0	1	1
/datadrive/data/ESAdocs/federal_register/2015-26692.pdf	0	0	0	0	3	0	0	3	3
/datadrive/data/ESAdocs/federal_register/2015-27149.pdf	0	0	0	0	3	0	0	3	3
/datadrive/data/ESAdocs/federal_register/2015-27236.pdf	0	0	0	0	1	0	0	1	1
/datadrive/data/ESAdocs/federal_register/2015-27259.pdf	0	0	0	0	1	0	0	1	3
/datadrive/data/ESAdocs/federal_register/2015-27639.pdf	3	0	0	0	15	0	0	18	18
/datadrive/data/ESAdocs/federal_register/2015-27947.pdf	0	0	0	0	2	0	0	2	3
/datadrive/data/ESAdocs/federal_register/2015-31369.pdf	0	0	0	0	2	1	0	3	2
/datadrive/data/ESAdocs/federal_register/2015-31725.pdf	0	0	0	0	2	0	0	2	2
/datadrive/data/ESAdocs/federal_register/2015-31958.pdf	30	1	13	0	46	0	0	90	58
/datadrive/data/ESAdocs/federal_register/2015-31982.pdf	1	0	1	2	16	1	0	21	22
/datadrive/data/ESAdocs/federal_register/2015-32075.pdf	5	0	1	2	10	2	0	20	12
/datadrive/data/ESAdocs/federal_register/2015-32108.pdf	0	0	0	0	2	0	0	2	2
/datadrive/data/ESAdocs/federal_register/2015-32284.pdf	2	1	0	2	25	2	1	33	32
/datadrive/data/ESAdocs/federal_register/2015-32645.pdf	0	0	0	0	25	2	3	30	28
/datadrive/data/ESAdocs/federal_register/2015-33156.pdf	0	0	0	0	2	0	0	2	2
/datadrive/data/ESAdocs/federal_register/2016-00157.pdf	0	0	0	0	4	0	0	4	8
/datadrive/data/ESAdocs/federal_register/2016-00617.pdf	0	0	1	0	15	0	1	17	23
/datadrive/data/ESAdocs/federal_register/2016-01131.pdf	0	0	1	0	2	0	0	3	2
/datadrive/data/ESAdocs/federal_register/2016-01141.pdf	0	0	0	1	18	5	1	25	61
/datadrive/data/ESAdocs/federal_register/2016-01142.pdf	0	0	0	0	2	0	0	2	2
/datadrive/data/ESAdocs/federal_register/2016-01143.pdf	0	0	0	0	1	0	0	1	2
/datadrive/data/ESAdocs/federal_register/2016-02669.pdf	1	0	0	0	16	1	0	18	19
/datadrive/data/ESAdocs/federal_register/2016-02895.pdf	0	0	0	0	2	0	0	2	3
/datadrive/data/ESAdocs/federal_register/2016-03256.pdf	0	0	0	0	2	0	0	2	4
/datadrive/data/ESAdocs/federal_register/2016-03296.pdf	0	0	0	0	8	0	0	8	11
/datadrive/data/ESAdocs/federal_register/2016-04095.pdf	0	0	0	0	2	0	0	2	2
/datadrive/data/ESAdocs/federal_register/2016-05083.pdf	2	0	0	0	2	1	0	5	2
/datadrive/data/ESAdocs/federal_register/2016-05167.pdf	25	6	4	0	48	0	0	83	55
/datadrive/data/ESAdocs/federal_register/2016-05492.pdf	1	0	0	0	2	0	0	3	2
/datadrive/data/ESAdocs/federal_register/2016-05699.pdf	1	0	1	0	6	0	0	8	15
/datadrive/data/ESAdocs/federal_register/2016-05899.pdf	0	0	0	0	2	0	0	2	2
/datadrive/data/ESAdocs/federal_register/2016-05912.pdf	14	1	5	1	49	2	1	73	63
/datadrive/data/ESAdocs/federal_register/2016-06069.pdf	1	3	6	3	127	0	3	143	322
/datadrive/data/ESAdocs/federal_register/2016-07227.pdf	0	1	0	0	2	0	2	5	4
/datadrive/data/ESAdocs/federal_register/2016-07389.pdf	0	0	0	0	2	0	0	2	2
/datadrive/data/ESAdocs/federal_register/2016-07492.pdf	1	0	1	1	11	0	0	14	15
/datadrive/data/ESAdocs/federal_register/2016-07587.pdf	0	0	0	0	26	5	1	32	34
/datadrive/data/ESAdocs/federal_register/2016-07744.pdf	0	0	0	0	26	21	13	60	33
/datadrive/data/ESAdocs/federal_register/2016-07809.pdf	1	0	2	1	13	0	0	17	16
/datadrive/data/ESAdocs/federal_register/2016-08238.pdf	0	0	0	0	3	0	0	3	3
/datadrive/data/ESAdocs/federal_register/2016-08241.pdf	0	0	0	0	1	0	0	1	1
/datadrive/data/ESAdocs/federal_register/2016-08615.pdf	0	0	0	0	1	0	0	1	2
/datadrive/data/ESAdocs/federal_register/2016-08617.pdf	0	0	0	0	1	0	0	1	3
/datadrive/data/ESAdocs/federal_register/2016-09104.pdf	0	0	0	0	1	0	0	1	1
/datadrive/data/ESAdocs/federal_register/2016-09673.pdf	0	0	0	0	7	0	0	7	8
/datadrive/data/ESAdocs/federal_register/2016-10517.pdf	1	1	0	0	1	0	0	3	2
/datadrive/data/ESAdocs/federal_register/2016-10712.pdf	6	0	2	0	35	2	5	50	62
/datadrive/data/ESAdocs/federal_register/2016-10939.pdf	0	0	0	0	2	0	0	2	2
/datadrive/data/ESAdocs/federal_register/2016-11039.pdf	0	0	0	0	1	0	0	1	2
/datadrive/data/ESAdocs/federal_register/2016-11941.pdf	0	0	0	0	7	0	0	7	9
/datadrive/data/ESAdocs/federal_register/2016-12079.pdf	0	0	0	0	2	0	0	2	2
/datadrive/data/ESAdocs/federal_register/2016-12585.pdf	0	0	0	0	2	0	0	2	3
/datadrive/data/ESAdocs/federal_register/2016-13120.pdf	0	0	0	0	3	0	0	3	4
/datadrive/data/ESAdocs/federal_register/2016-13124.pdf	0	0	0	2	26	3	0	31	39
/datadrive/data/ESAdocs/federal_register/2016-13173.pdf	0	0	0	0	20	0	0	20	33
/datadrive/data/ESAdocs/federal_register/2016-13246.pdf	6	0	1	1	19	4	4	35	25
/datadrive/data/ESAdocs/federal_register/2016-14456.pdf	0	0	0	0	2	0	0	2	2
/datadrive/data/ESAdocs/federal_register/2016-14539.pdf	0	0	0	0	15	0	0	15	19
/datadrive/data/ESAdocs/federal_register/2016-14540.pdf	2	0	0	0	13	0	1	16	14
/datadrive/data/ESAdocs/federal_register/2016-15227.pdf	0	0	0	0	1	0	0	1	2
/datadrive/data/ESAdocs/federal_register/2016-18096.pdf	0	0	0	0	2	0	0	2	2
/datadrive/data/ESAdocs/federal_register/2016-18376.pdf	0	0	0	0	17	0	1	18	23
/datadrive/data/ESAdocs/federal_register/2016-18778.pdf	0	1	1	0	15	1	0	18	19
/datadrive/data/ESAdocs/federal_register/2016-18816.pdf	2	0	1	0	9	7	8	27	14
/datadrive/data/ESAdocs/federal_register/2016-19159.pdf	18	1	8	3	38	1	1	70	49
/datadrive/data/ESAdocs/federal_register/2016-19340.pdf	0	0	0	0	1	0	0	1	2
/datadrive/data/ESAdocs/federal_register/2016-19528.pdf	6	0	1	2	25	1	0	35	28
/datadrive/data/ESAdocs/federal_register/2016-19940.pdf	0	0	0	0	2	0	0	2	2
/datadrive/data/ESAdocs/federal_register/2016-20352.pdf	5	0	2	0	45	1	13	66	75
/datadrive/data/ESAdocs/federal_register/2016-20670.pdf	0	0	0	0	3	0	0	3	3
/datadrive/data/ESAdocs/federal_register/2016-21276.pdf	0	0	0	0	48	0	0	48	62
/datadrive/data/ESAdocs/federal_register/2016-21368.pdf	0	0	0	0	3	0	0	3	4
/datadrive/data/ESAdocs/federal_register/2016-21587.pdf	2	0	0	2	12	0	0	16	15
/datadrive/data/ESAdocs/federal_register/2016-21588.pdf	3	0	0	2	5	0	0	10	6
/datadrive/data/ESAdocs/federal_register/2016-21845.pdf	0	0	0	0	3	0	0	3	3
/datadrive/data/ESAdocs/federal_register/2016-21954.pdf	0	0	0	0	5	0	0	5	8
/datadrive/data/ESAdocs/federal_register/2016-22167.pdf	0	0	0	0	12	1	0	13	13
/datadrive/data/ESAdocs/federal_register/2016-22276.pdf	0	0	2	2	37	0	0	41	44
/datadrive/data/ESAdocs/federal_register/2016-22592.pdf	0	0	1	1	10	0	0	12	13
/datadrive/data/ESAdocs/federal_register/2016-22752.pdf	0	0	0	0	9	6	7	22	12
/datadrive/data/ESAdocs/federal_register/2016-22754.pdf	2	0	0	0	7	0	0	9	15
/datadrive/data/ESAdocs/federal_register/2016-22799.pdf	0	0	0	0	10	0	0	10	11
/datadrive/data/ESAdocs/federal_register/2016-23103.pdf	0	0	0	0	14	9	9	32	18
/datadrive/data/ESAdocs/federal_register/2016-23539.pdf	2	0	0	0	24	6	8	40	52
/datadrive/data/ESAdocs/federal_register/2016-23545.pdf	0	0	0	0	20	11	7	38	23
/datadrive/data/ESAdocs/federal_register/2016-23546.pdf	0	0	0	0	21	2	0	23	24
/datadrive/data/ESAdocs/federal_register/2016-23710.pdf	0	0	0	0	12	1	0	13	19
/datadrive/data/ESAdocs/federal_register/2016-23945.pdf	1	0	1	2	21	2	0	27	23
/datadrive/data/ESAdocs/federal_register/2016-24113.pdf	0	0	0	0	17	0	1	18	22
/datadrive/data/ESAdocs/federal_register/2016-24118.pdf	1	0	0	0	12	5	6	24	26
/datadrive/data/ESAdocs/federal_register/2016-24119.pdf	0	0	1	0	7	4	4	16	9
/datadrive/data/ESAdocs/federal_register/2016-24140.pdf	0	0	0	0	25	1	0	26	27
/datadrive/data/ESAdocs/federal_register/2016-24790.pdf	2	2	2	0	20	0	0	26	25
/datadrive/data/ESAdocs/federal_register/2016-24929.pdf	0	0	0	0	1	0	0	1	2
/datadrive/data/ESAdocs/federal_register/2016-26125.pdf	0	0	0	0	1	0	0	1	2
/datadrive/data/ESAdocs/federal_register/2016-26241.pdf	0	0	0	0	1	0	0	1	4
/datadrive/data/ESAdocs/federal_register/2016-26330.pdf	0	0	0	0	1	0	2	3	2
/datadrive/data/ESAdocs/federal_register/2016-28318.pdf	3	0	13	4	16	0	0	36	20
/datadrive/data/ESAdocs/federal_register/2016-28513.pdf	0	0	0	0	2	0	0	2	4
/datadrive/data/ESAdocs/federal_register/2016-28817.pdf	2	1	0	2	21	3	2	31	27
/datadrive/data/ESAdocs/federal_register/95-27962.pdf	0	0	0	0	1	0	0	1	3
/datadrive/data/ESAdocs/federal_register/99-11187.pdf	2	0	0	0	13	0	0	15	14
/datadrive/data/ESAdocs/federal_register/citation.result.FR.action?federalRegister.volume=1995andfederalRegister.page=49359andpublication=FR.pdf	1	0	4	0	16	0	0	21	19
/datadrive/data/ESAdocs/federal_register/citation.result.FR.action?federalRegister.volume=1995andfederalRegister.page=5264andpublication=FR.pdf	0	0	0	0	3	0	0	3	4
/datadrive/data/ESAdocs/federal_register/citation.result.FR.action?federalRegister.volume=1995andfederalRegister.page=9485andpublication=FR.pdf	0	0	1	0	27	0	0	28	44
/datadrive/data/ESAdocs/federal_register/citation.result.FR.action?federalRegister.volume=1998andfederalRegister.page=25062andpublication=FR.pdf	1	0	0	0	2	0	0	3	2
/datadrive/data/ESAdocs/federal_register/citation.result.FR.action?federalRegister.volume=1998andfederalRegister.page=25063andpublication=FR.pdf	0	0	0	0	2	0	0	2	2
/datadrive/data/ESAdocs/federal_register/citation.result.FR.action?federalRegister.volume=1999andfederalRegister.page=14529andpublication=FR.pdf	1	0	0	0	8	0	0	9	9
/datadrive/data/ESAdocs/federal_register/citation.result.FR.action?federalRegister.volume=1999andfederalRegister.page=3066andpublication=FR.pdf	0	0	0	0	2	0	0	2	2
/datadrive/data/ESAdocs/federal_register/citation.result.FR.action?federalRegister.volume=1999andfederalRegister.page=34216andpublication=FR.pdf	0	0	0	0	2	0	0	2	2
/datadrive/data/ESAdocs/federal_register/citation.result.FR.action?federalRegister.volume=1999andfederalRegister.page=5740andpublication=FR.pdf	2	0	0	0	12	0	0	14	15
/datadrive/data/ESAdocs/federal_register/citation.result.FR.action?federalRegister.volume=1999andfederalRegister.page=68508andpublication=FR.pdf	1	0	0	0	16	0	0	17	37
/datadrive/data/ESAdocs/federal_register/citation.result.FR.action?federalRegister.volume=1999andfederalRegister.page=70695andpublication=FR.pdf	2	0	0	0	3	0	0	5	3
/datadrive/data/ESAdocs/federal_register/citation.result.FR.action?federalRegister.volume=1999andfederalRegister.page=907andpublication=FR.pdf	0	0	0	0	2	0	0	2	2
/datadrive/data/ESAdocs/federal_register/citation.result.FR.action?federalRegister.volume=2000andfederalRegister.page=13947andpublication=FR.pdf	0	0	0	0	1	0	0	1	2
/datadrive/data/ESAdocs/federal_register/citation.result.FR.action?federalRegister.volume=2000andfederalRegister.page=17787andpublication=FR.pdf	0	0	0	1	10	4	4	19	19
/datadrive/data/ESAdocs/federal_register/citation.result.FR.action?federalRegister.volume=2000andfederalRegister.page=24222andpublication=FR.pdf	0	0	1	0	2	0	0	3	2
/datadrive/data/ESAdocs/federal_register/citation.result.FR.action?federalRegister.volume=2000andfederalRegister.page=24328andpublication=FR.pdf	6	2	1	0	38	8	1	56	46
/datadrive/data/ESAdocs/federal_register/citation.result.FR.action?federalRegister.volume=2000andfederalRegister.page=31869andpublication=FR.pdf	0	0	0	0	1	0	0	1	2
/datadrive/data/ESAdocs/federal_register/citation.result.FR.action?federalRegister.volume=2000andfederalRegister.page=31870andpublication=FR.pdf	0	0	0	0	1	0	0	1	2
/datadrive/data/ESAdocs/federal_register/citation.result.FR.action?federalRegister.volume=2000andfederalRegister.page=33283andpublication=FR.pdf	0	0	0	0	6	1	1	8	9
/datadrive/data/ESAdocs/federal_register/citation.result.FR.action?federalRegister.volume=2000andfederalRegister.page=35025andpublication=FR.pdf	0	0	1	4	8	0	0	13	9
/datadrive/data/ESAdocs/federal_register/citation.result.FR.action?federalRegister.volume=2000andfederalRegister.page=35033andpublication=FR.pdf	0	0	0	0	6	0	0	6	8
/datadrive/data/ESAdocs/federal_register/citation.result.FR.action?federalRegister.volume=2000andfederalRegister.page=36075andpublication=FR.pdf	2	0	0	0	19	7	3	31	21
/datadrive/data/ESAdocs/federal_register/citation.result.FR.action?federalRegister.volume=2000andfederalRegister.page=36512andpublication=FR.pdf	1	0	0	0	16	4	2	23	38
/datadrive/data/ESAdocs/federal_register/citation.result.FR.action?federalRegister.volume=2000andfederalRegister.page=37343andpublication=FR.pdf	9	0	2	1	14	1	4	31	15
/datadrive/data/ESAdocs/federal_register/citation.result.FR.action?federalRegister.volume=2000andfederalRegister.page=37796andpublication=FR.pdf	1	0	0	0	2	0	0	3	2
/datadrive/data/ESAdocs/federal_register/citation.result.FR.action?federalRegister.volume=2000andfederalRegister.page=39117andpublication=FR.pdf	0	0	0	0	2	0	0	2	3
/datadrive/data/ESAdocs/federal_register/citation.result.FR.action?federalRegister.volume=2000andfederalRegister.page=40073andpublication=FR.pdf	0	0	0	0	2	0	0	2	2
/datadrive/data/ESAdocs/federal_register/citation.result.FR.action?federalRegister.volume=2000andfederalRegister.page=40576andpublication=FR.pdf	1	0	0	0	17	2	3	23	25
/datadrive/data/ESAdocs/federal_register/citation.result.FR.action?federalRegister.volume=2000andfederalRegister.page=41404andpublication=FR.pdf	0	1	0	0	1	0	0	2	2
/datadrive/data/ESAdocs/federal_register/citation.result.FR.action?federalRegister.volume=2000andfederalRegister.page=41405andpublication=FR.pdf	1	13	0	0	14	1	0	29	20
/datadrive/data/ESAdocs/federal_register/citation.result.FR.action?federalRegister.volume=2000andfederalRegister.page=41782andpublication=FR.pdf	0	1	0	0	14	2	2	19	31
/datadrive/data/ESAdocs/federal_register/citation.result.FR.action?federalRegister.volume=2000andfederalRegister.page=41812andpublication=FR.pdf	0	0	0	0	14	0	0	14	24
/datadrive/data/ESAdocs/federal_register/citation.result.FR.action?federalRegister.volume=2000andfederalRegister.page=41917andpublication=FR.pdf	0	0	0	0	12	0	0	12	13
/datadrive/data/ESAdocs/federal_register/citation.result.FR.action?federalRegister.volume=2000andfederalRegister.page=42316andpublication=FR.pdf	0	0	0	0	1	0	0	1	3
/datadrive/data/ESAdocs/federal_register/citation.result.FR.action?federalRegister.volume=2000andfederalRegister.page=42962andpublication=FR.pdf	0	0	0	0	7	0	0	7	12
/datadrive/data/ESAdocs/federal_register/citation.result.FR.action?federalRegister.volume=2000andfederalRegister.page=42973andpublication=FR.pdf	1	0	0	1	5	0	0	7	6
/datadrive/data/ESAdocs/federal_register/citation.result.FR.action?federalRegister.volume=2000andfederalRegister.page=43450andpublication=FR.pdf	27	6	5	0	47	0	0	85	48
/datadrive/data/ESAdocs/federal_register/citation.result.FR.action?federalRegister.volume=2000andfederalRegister.page=44717andpublication=FR.pdf	1	0	0	0	14	1	0	16	37
/datadrive/data/ESAdocs/federal_register/citation.result.FR.action?federalRegister.volume=2000andfederalRegister.page=45336andpublication=FR.pdf	2	0	0	0	11	0	0	13	18
/datadrive/data/ESAdocs/federal_register/citation.result.FR.action?federalRegister.volume=2000andfederalRegister.page=4603andpublication=FR.pdf	0	0	0	0	2	0	1	3	2
/datadrive/data/ESAdocs/federal_register/citation.result.FR.action?federalRegister.volume=2000andfederalRegister.page=46391andpublication=FR.pdf	5	0	0	0	6	0	0	11	8
/datadrive/data/ESAdocs/federal_register/citation.result.FR.action?federalRegister.volume=2000andfederalRegister.page=46643andpublication=FR.pdf	0	0	0	0	11	0	0	11	12
/datadrive/data/ESAdocs/federal_register/citation.result.FR.action?federalRegister.volume=2000andfederalRegister.page=46684andpublication=FR.pdf	0	0	0	0	1	0	0	1	2
/datadrive/data/ESAdocs/federal_register/citation.result.FR.action?federalRegister.volume=2000andfederalRegister.page=49530andpublication=FR.pdf	0	0	0	0	1	0	0	1	2
/datadrive/data/ESAdocs/federal_register/citation.result.FR.action?federalRegister.volume=2000andfederalRegister.page=49781andpublication=FR.pdf	0	0	0	0	0	0	0	0	2
/datadrive/data/ESAdocs/federal_register/citation.result.FR.action?federalRegister.volume=2000andfederalRegister.page=50672andpublication=FR.pdf	0	0	0	0	1	0	0	1	2
/datadrive/data/ESAdocs/federal_register/citation.result.FR.action?federalRegister.volume=2000andfederalRegister.page=52691andpublication=FR.pdf	0	0	0	0	1	0	0	1	2
/datadrive/data/ESAdocs/federal_register/citation.result.FR.action?federalRegister.volume=2000andfederalRegister.page=53222andpublication=FR.pdf	0	0	0	0	1	0	0	1	2
/datadrive/data/ESAdocs/federal_register/citation.result.FR.action?federalRegister.volume=2000andfederalRegister.page=53691andpublication=FR.pdf	1	0	0	1	1	0	0	3	2
/datadrive/data/ESAdocs/federal_register/citation.result.FR.action?federalRegister.volume=2000andfederalRegister.page=54177andpublication=FR.pdf	0	0	0	0	0	0	0	0	2
/datadrive/data/ESAdocs/federal_register/citation.result.FR.action?federalRegister.volume=2000andfederalRegister.page=54472andpublication=FR.pdf	1	0	0	0	3	0	0	4	3
/datadrive/data/ESAdocs/federal_register/citation.result.FR.action?federalRegister.volume=2000andfederalRegister.page=54892andpublication=FR.pdf	0	1	0	0	17	2	1	21	42
/datadrive/data/ESAdocs/federal_register/citation.result.FR.action?federalRegister.volume=2000andfederalRegister.page=55270andpublication=FR.pdf	0	0	0	0	0	0	0	0	2
/datadrive/data/ESAdocs/federal_register/citation.result.FR.action?federalRegister.volume=2000andfederalRegister.page=56530andpublication=FR.pdf	0	0	0	0	1	0	0	1	2
/datadrive/data/ESAdocs/federal_register/citation.result.FR.action?federalRegister.volume=2000andfederalRegister.page=56590andpublication=FR.pdf	0	0	0	0	3	0	0	3	3
/datadrive/data/ESAdocs/federal_register/citation.result.FR.action?federalRegister.volume=2000andfederalRegister.page=57136andpublication=FR.pdf	0	0	0	0	11	1	1	13	24
/datadrive/data/ESAdocs/federal_register/citation.result.FR.action?federalRegister.volume=2000andfederalRegister.page=57170andpublication=FR.pdf	0	0	0	0	0	1	0	1	2
/datadrive/data/ESAdocs/federal_register/citation.result.FR.action?federalRegister.volume=2000andfederalRegister.page=57242andpublication=FR.pdf	2	1	2	1	22	1	1	30	24
/datadrive/data/ESAdocs/federal_register/citation.result.FR.action?federalRegister.volume=2000andfederalRegister.page=57800andpublication=FR.pdf	0	0	0	0	3	0	0	3	3
/datadrive/data/ESAdocs/federal_register/citation.result.FR.action?federalRegister.volume=2000andfederalRegister.page=58258andpublication=FR.pdf	0	0	0	0	3	0	0	3	4
/datadrive/data/ESAdocs/federal_register/citation.result.FR.action?federalRegister.volume=2000andfederalRegister.page=58784andpublication=FR.pdf	0	0	0	0	2	0	0	2	2
/datadrive/data/ESAdocs/federal_register/citation.result.FR.action?federalRegister.volume=2000andfederalRegister.page=58933andpublication=FR.pdf	0	0	0	1	16	0	0	17	30
/datadrive/data/ESAdocs/federal_register/citation.result.FR.action?federalRegister.volume=2000andfederalRegister.page=58981andpublication=FR.pdf	0	0	0	0	2	0	0	2	2
/datadrive/data/ESAdocs/federal_register/citation.result.FR.action?federalRegister.volume=2000andfederalRegister.page=59798andpublication=FR.pdf	0	0	0	1	11	0	0	12	17
/datadrive/data/ESAdocs/federal_register/citation.result.FR.action?federalRegister.volume=2000andfederalRegister.page=60603andpublication=FR.pdf	3	0	0	1	3	1	0	8	3
/datadrive/data/ESAdocs/federal_register/citation.result.FR.action?federalRegister.volume=2000andfederalRegister.page=60607andpublication=FR.pdf	2	0	0	0	2	0	0	4	3
/datadrive/data/ESAdocs/federal_register/citation.result.FR.action?federalRegister.volume=2000andfederalRegister.page=60879andpublication=FR.pdf	2	0	0	0	10	0	0	12	11
/datadrive/data/ESAdocs/federal_register/citation.result.FR.action?federalRegister.volume=2000andfederalRegister.page=61218andpublication=FR.pdf	0	0	0	0	15	0	0	15	28
/datadrive/data/ESAdocs/federal_register/citation.result.FR.action?federalRegister.volume=2000andfederalRegister.page=61355andpublication=FR.pdf	0	0	0	0	2	0	0	2	2
/datadrive/data/ESAdocs/federal_register/citation.result.FR.action?federalRegister.volume=2000andfederalRegister.page=62302andpublication=FR.pdf	2	0	1	1	9	0	0	13	9
/datadrive/data/ESAdocs/federal_register/citation.result.FR.action?federalRegister.volume=2000andfederalRegister.page=62690andpublication=FR.pdf	0	1	0	0	1	0	0	2	2
/datadrive/data/ESAdocs/federal_register/citation.result.FR.action?federalRegister.volume=2000andfederalRegister.page=62691andpublication=FR.pdf	0	2	0	0	1	1	0	4	2
/datadrive/data/ESAdocs/federal_register/citation.result.FR.action?federalRegister.volume=2000andfederalRegister.page=63044andpublication=FR.pdf	2	0	2	0	2	1	0	7	4
/datadrive/data/ESAdocs/federal_register/citation.result.FR.action?federalRegister.volume=2000andfederalRegister.page=63438andpublication=FR.pdf	0	0	0	0	18	0	1	19	30
/datadrive/data/ESAdocs/federal_register/citation.result.FR.action?federalRegister.volume=2000andfederalRegister.page=63680andpublication=FR.pdf	0	0	0	0	28	1	0	29	65
/datadrive/data/ESAdocs/federal_register/citation.result.FR.action?federalRegister.volume=2000andfederalRegister.page=64414andpublication=FR.pdf	0	0	0	0	1	0	0	1	2
/datadrive/data/ESAdocs/federal_register/citation.result.FR.action?federalRegister.volume=2000andfederalRegister.page=64649andpublication=FR.pdf	0	0	0	1	2	0	0	3	2
/datadrive/data/ESAdocs/federal_register/citation.result.FR.action?federalRegister.volume=2000andfederalRegister.page=65287andpublication=FR.pdf	0	0	0	0	1	0	0	1	2
/datadrive/data/ESAdocs/federal_register/citation.result.FR.action?federalRegister.volume=2000andfederalRegister.page=6590andpublication=FR.pdf	0	0	0	0	2	0	0	2	2
/datadrive/data/ESAdocs/federal_register/citation.result.FR.action?federalRegister.volume=2000andfederalRegister.page=67334andpublication=FR.pdf	0	0	0	0	2	0	0	2	2
/datadrive/data/ESAdocs/federal_register/citation.result.FR.action?federalRegister.volume=2000andfederalRegister.page=67335andpublication=FR.pdf	1	0	1	0	9	0	1	12	9
/datadrive/data/ESAdocs/federal_register/citation.result.FR.action?federalRegister.volume=2000andfederalRegister.page=69459andpublication=FR.pdf	2	10	0	0	24	1	1	38	25
/datadrive/data/ESAdocs/federal_register/citation.result.FR.action?federalRegister.volume=2000andfederalRegister.page=69624andpublication=FR.pdf	12	4	4	0	17	0	0	37	21
/datadrive/data/ESAdocs/federal_register/citation.result.FR.action?federalRegister.volume=2000andfederalRegister.page=69896andpublication=FR.pdf	0	0	0	0	2	0	0	2	2
/datadrive/data/ESAdocs/federal_register/citation.result.FR.action?federalRegister.volume=2000andfederalRegister.page=76207andpublication=FR.pdf	0	0	0	0	3	0	0	3	3
/datadrive/data/ESAdocs/federal_register/citation.result.FR.action?federalRegister.volume=2000andfederalRegister.page=77178andpublication=FR.pdf	1	0	0	0	13	2	1	17	32
/datadrive/data/ESAdocs/federal_register/citation.result.FR.action?federalRegister.volume=2000andfederalRegister.page=7856andpublication=FR.pdf	0	0	0	0	1	0	0	1	2
/datadrive/data/ESAdocs/federal_register/citation.result.FR.action?federalRegister.volume=2000andfederalRegister.page=79192andpublication=FR.pdf	0	1	14	10	48	0	1	74	85
/datadrive/data/ESAdocs/federal_register/citation.result.FR.action?federalRegister.volume=2000andfederalRegister.page=81182andpublication=FR.pdf	1	0	0	0	13	1	0	15	32
/datadrive/data/ESAdocs/federal_register/citation.result.FR.action?federalRegister.volume=2000andfederalRegister.page=82086andpublication=FR.pdf	0	4	5	1	31	0	1	42	42
/datadrive/data/ESAdocs/federal_register/citation.result.FR.action?federalRegister.volume=2000andfederalRegister.page=83158andpublication=FR.pdf	1	1	7	4	42	0	1	56	60
/datadrive/data/ESAdocs/federal_register/citation.result.FR.action?federalRegister.volume=2000andfederalRegister.page=8434andpublication=FR.pdf	0	0	0	0	2	0	0	2	3
/datadrive/data/ESAdocs/federal_register/citation.result.FR.action?federalRegister.volume=2001andfederalRegister.page=1089andpublication=FR.pdf	0	0	0	0	3	0	0	3	3
/datadrive/data/ESAdocs/federal_register/citation.result.FR.action?federalRegister.volume=2001andfederalRegister.page=18002andpublication=FR.pdf	4	0	1	1	29	5	9	49	34
/datadrive/data/ESAdocs/federal_register/citation.result.FR.action?federalRegister.volume=2001andfederalRegister.page=29046andpublication=FR.pdf	0	0	0	0	7	0	0	7	10
/datadrive/data/ESAdocs/federal_register/citation.result.FR.action?federalRegister.volume=2001andfederalRegister.page=30746andpublication=FR.pdf	1	0	2	0	2	0	0	5	2
/datadrive/data/ESAdocs/federal_register/citation.result.FR.action?federalRegister.volume=2001andfederalRegister.page=33623andpublication=FR.pdf	0	0	0	0	1	0	0	1	2
/datadrive/data/ESAdocs/federal_register/citation.result.FR.action?federalRegister.volume=2001andfederalRegister.page=35451andpublication=FR.pdf	0	0	0	0	2	0	0	2	2
/datadrive/data/ESAdocs/federal_register/citation.result.FR.action?federalRegister.volume=2001andfederalRegister.page=35547andpublication=FR.pdf	0	0	0	1	12	0	0	13	20
/datadrive/data/ESAdocs/federal_register/citation.result.FR.action?federalRegister.volume=2001andfederalRegister.page=36137andpublication=FR.pdf	0	6	0	0	39	3	2	50	107
/datadrive/data/ESAdocs/federal_register/citation.result.FR.action?federalRegister.volume=2001andfederalRegister.page=45829andpublication=FR.pdf	0	0	0	0	4	0	0	4	5
/datadrive/data/ESAdocs/federal_register/citation.result.FR.action?federalRegister.volume=2001andfederalRegister.page=52638andpublication=FR.pdf	0	0	0	0	3	1	0	4	3
/datadrive/data/ESAdocs/federal_register/citation.result.FR.action?federalRegister.volume=2001andfederalRegister.page=63752andpublication=FR.pdf	0	0	4	0	18	0	0	22	32
/datadrive/data/ESAdocs/federal_register/citation.result.FR.action?federalRegister.volume=2001andfederalRegister.page=9476andpublication=FR.pdf	0	0	0	1	14	0	0	15	33
/datadrive/data/ESAdocs/federal_register/citation.result.FR.action?federalRegister.volume=2002andfederalRegister.page=35942andpublication=FR.pdf	4	11	0	0	11	0	0	26	16
/datadrive/data/ESAdocs/federal_register/citation.result.FR.action?federalRegister.volume=2002andfederalRegister.page=39737andpublication=FR.pdf	0	0	0	0	3	0	0	3	3
/datadrive/data/ESAdocs/federal_register/citation.result.FR.action?federalRegister.volume=2002andfederalRegister.page=45755andpublication=FR.pdf	1	0	0	0	2	0	0	3	2
/datadrive/data/ESAdocs/federal_register/citation.result.FR.action?federalRegister.volume=2002andfederalRegister.page=67803andpublication=FR.pdf	0	0	2	0	12	2	1	17	16
/datadrive/data/ESAdocs/federal_register/citation.result.FR.action?federalRegister.volume=2003andfederalRegister.page=13370andpublication=FR.pdf	0	0	2	0	37	14	11	64	127
/datadrive/data/ESAdocs/federal_register/citation.result.FR.action?federalRegister.volume=2003andfederalRegister.page=14581andpublication=FR.pdf	0	0	0	0	2	0	0	2	3
/datadrive/data/ESAdocs/federal_register/citation.result.FR.action?federalRegister.volume=2003andfederalRegister.page=14752andpublication=FR.pdf	1	0	3	0	17	7	3	31	82
/datadrive/data/ESAdocs/federal_register/citation.result.FR.action?federalRegister.volume=2003andfederalRegister.page=16602andpublication=FR.pdf	0	0	0	0	18	0	1	19	41
/datadrive/data/ESAdocs/federal_register/citation.result.FR.action?federalRegister.volume=2003andfederalRegister.page=17156andpublication=FR.pdf	1	0	1	0	34	2	3	41	77
/datadrive/data/ESAdocs/federal_register/citation.result.FR.action?federalRegister.volume=2003andfederalRegister.page=19888andpublication=FR.pdf	0	0	0	0	17	0	1	18	31
/datadrive/data/ESAdocs/federal_register/citation.result.FR.action?federalRegister.volume=2003andfederalRegister.page=20228andpublication=FR.pdf	0	0	0	0	22	1	0	23	86
/datadrive/data/ESAdocs/federal_register/citation.result.FR.action?federalRegister.volume=2003andfederalRegister.page=204andpublication=FR.pdf	0	0	0	0	11	0	0	11	34
/datadrive/data/ESAdocs/federal_register/citation.result.FR.action?federalRegister.volume=2003andfederalRegister.page=24615andpublication=FR.pdf	0	0	0	0	3	0	0	3	23
/datadrive/data/ESAdocs/federal_register/citation.result.FR.action?federalRegister.volume=2003andfederalRegister.page=26033andpublication=FR.pdf	2	1	23	9	80	1	2	118	233
/datadrive/data/ESAdocs/federal_register/citation.result.FR.action?federalRegister.volume=2003andfederalRegister.page=34710andpublication=FR.pdf	1	0	6	0	42	1	2	52	58
/datadrive/data/ESAdocs/federal_register/citation.result.FR.action?federalRegister.volume=2003andfederalRegister.page=36149andpublication=FR.pdf	3	0	37	15	122	0	1	178	458
/datadrive/data/ESAdocs/federal_register/citation.result.FR.action?federalRegister.volume=2003andfederalRegister.page=37276andpublication=FR.pdf	1	1	1	0	30	6	0	39	58
/datadrive/data/ESAdocs/federal_register/citation.result.FR.action?federalRegister.volume=2003andfederalRegister.page=46733andpublication=FR.pdf	2	0	4	0	100	3	33	142	185
/datadrive/data/ESAdocs/federal_register/citation.result.FR.action?federalRegister.volume=2003andfederalRegister.page=46870andpublication=FR.pdf	0	0	0	0	22	0	1	23	49
/datadrive/data/ESAdocs/federal_register/citation.result.FR.action?federalRegister.volume=2003andfederalRegister.page=60112andpublication=FR.pdf	1	0	0	0	3	0	0	4	4
/datadrive/data/ESAdocs/federal_register/citation.result.FR.action?federalRegister.volume=2003andfederalRegister.page=66820andpublication=FR.pdf	0	0	1	0	2	0	2	5	2
/datadrive/data/ESAdocs/federal_register/citation.result.FR.action?federalRegister.volume=2003andfederalRegister.page=8088andpublication=FR.pdf	2	0	1	0	48	7	14	72	49
/datadrive/data/ESAdocs/federal_register/citation.result.FR.action?federalRegister.volume=2003andfederalRegister.page=9265andpublication=FR.pdf	1	1	23	13	117	0	1	156	365
/datadrive/data/ESAdocs/federal_register/citation.result.FR.action?federalRegister.volume=2004andfederalRegister.page=17383andpublication=FR.pdf	0	0	0	0	2	1	0	3	4
/datadrive/data/ESAdocs/federal_register/citation.result.FR.action?federalRegister.volume=2004andfederalRegister.page=18279andpublication=FR.pdf	0	0	0	0	9	0	1	10	13
/datadrive/data/ESAdocs/federal_register/citation.result.FR.action?federalRegister.volume=2004andfederalRegister.page=2726andpublication=FR.pdf	0	0	0	0	2	0	0	2	2
/datadrive/data/ESAdocs/federal_register/citation.result.FR.action?federalRegister.volume=2004andfederalRegister.page=29081andpublication=FR.pdf	0	0	1	1	17	0	0	19	20
/datadrive/data/ESAdocs/federal_register/citation.result.FR.action?federalRegister.volume=2004andfederalRegister.page=29121andpublication=FR.pdf	0	1	0	0	1	0	0	2	2
/datadrive/data/ESAdocs/federal_register/citation.result.FR.action?federalRegister.volume=2004andfederalRegister.page=31569andpublication=FR.pdf	1	1	1	1	10	2	0	16	14
/datadrive/data/ESAdocs/federal_register/citation.result.FR.action?federalRegister.volume=2004andfederalRegister.page=40084andpublication=FR.pdf	1	0	4	0	15	8	11	39	89
/datadrive/data/ESAdocs/federal_register/citation.result.FR.action?federalRegister.volume=2004andfederalRegister.page=43664andpublication=FR.pdf	9	1	2	0	27	0	0	39	30
/datadrive/data/ESAdocs/federal_register/citation.result.FR.action?federalRegister.volume=2004andfederalRegister.page=47834andpublication=FR.pdf	3	0	0	0	14	1	0	18	29
/datadrive/data/ESAdocs/federal_register/citation.result.FR.action?federalRegister.volume=2004andfederalRegister.page=48115andpublication=FR.pdf	0	0	0	0	9	0	1	10	13
/datadrive/data/ESAdocs/federal_register/citation.result.FR.action?federalRegister.volume=2004andfederalRegister.page=48570andpublication=FR.pdf	0	0	1	0	30	1	1	33	81
/datadrive/data/ESAdocs/federal_register/citation.result.FR.action?federalRegister.volume=2004andfederalRegister.page=52519andpublication=FR.pdf	0	0	0	0	2	0	0	2	2
/datadrive/data/ESAdocs/federal_register/citation.result.FR.action?federalRegister.volume=2004andfederalRegister.page=53136andpublication=FR.pdf	1	0	1	0	15	5	9	31	46
/datadrive/data/ESAdocs/federal_register/citation.result.FR.action?federalRegister.volume=2004andfederalRegister.page=59996andpublication=FR.pdf	3	4	1	0	49	8	13	78	82
/datadrive/data/ESAdocs/federal_register/citation.result.FR.action?federalRegister.volume=2004andfederalRegister.page=60110andpublication=FR.pdf	1	1	1	1	18	0	0	22	25
/datadrive/data/ESAdocs/federal_register/citation.result.FR.action?federalRegister.volume=2004andfederalRegister.page=60706andpublication=FR.pdf	4	0	1	0	32	2	0	39	82
/datadrive/data/ESAdocs/federal_register/citation.result.FR.action?federalRegister.volume=2004andfederalRegister.page=70971andpublication=FR.pdf	0	0	0	0	1	0	0	1	2
/datadrive/data/ESAdocs/federal_register/citation.result.FR.action?federalRegister.volume=2004andfederalRegister.page=71071andpublication=FR.pdf	1	1	0	0	2	0	0	4	2
/datadrive/data/ESAdocs/federal_register/citation.result.FR.action?federalRegister.volume=2004andfederalRegister.page=71284andpublication=FR.pdf	1	0	1	1	21	0	0	24	37
/datadrive/data/ESAdocs/federal_register/citation.result.FR.action?federalRegister.volume=2005andfederalRegister.page=15052andpublication=FR.pdf	0	0	0	0	6	0	0	6	12
/datadrive/data/ESAdocs/federal_register/citation.result.FR.action?federalRegister.volume=2005andfederalRegister.page=19154andpublication=FR.pdf	0	0	4	1	37	3	2	47	52
/datadrive/data/ESAdocs/federal_register/citation.result.FR.action?federalRegister.volume=2005andfederalRegister.page=2183andpublication=FR.pdf	0	0	0	0	1	0	0	1	2
/datadrive/data/ESAdocs/federal_register/citation.result.FR.action?federalRegister.volume=2005andfederalRegister.page=24450andpublication=FR.pdf	0	0	0	0	3	0	1	4	3
/datadrive/data/ESAdocs/federal_register/citation.result.FR.action?federalRegister.volume=2005andfederalRegister.page=29779andpublication=FR.pdf	0	0	0	0	1	0	0	1	2
/datadrive/data/ESAdocs/federal_register/citation.result.FR.action?federalRegister.volume=2005andfederalRegister.page=33015andpublication=FR.pdf	1	0	0	2	15	4	0	22	19
/datadrive/data/ESAdocs/federal_register/citation.result.FR.action?federalRegister.volume=2005andfederalRegister.page=33774andpublication=FR.pdf	6	0	8	2	19	0	0	35	23
/datadrive/data/ESAdocs/federal_register/citation.result.FR.action?federalRegister.volume=2005andfederalRegister.page=34492andpublication=FR.pdf	0	0	0	0	3	0	1	4	3
/datadrive/data/ESAdocs/federal_register/citation.result.FR.action?federalRegister.volume=2005andfederalRegister.page=3546andpublication=FR.pdf	0	0	0	0	2	0	2	4	3
/datadrive/data/ESAdocs/federal_register/citation.result.FR.action?federalRegister.volume=2005andfederalRegister.page=39327andpublication=FR.pdf	0	0	0	0	3	0	0	3	3
/datadrive/data/ESAdocs/federal_register/citation.result.FR.action?federalRegister.volume=2005andfederalRegister.page=41423andpublication=FR.pdf	0	0	0	0	2	0	0	2	2
/datadrive/data/ESAdocs/federal_register/citation.result.FR.action?federalRegister.volume=2005andfederalRegister.page=42533andpublication=FR.pdf	1	0	0	0	2	0	1	4	3
/datadrive/data/ESAdocs/federal_register/citation.result.FR.action?federalRegister.volume=2005andfederalRegister.page=426andpublication=FR.pdf	1	0	2	0	24	11	6	44	34
/datadrive/data/ESAdocs/federal_register/citation.result.FR.action?federalRegister.volume=2005andfederalRegister.page=46924andpublication=FR.pdf	0	0	2	0	32	1	2	37	77
/datadrive/data/ESAdocs/federal_register/citation.result.FR.action?federalRegister.volume=2005andfederalRegister.page=49380andpublication=FR.pdf	1	0	2	0	41	8	1	53	80
/datadrive/data/ESAdocs/federal_register/citation.result.FR.action?federalRegister.volume=2005andfederalRegister.page=52488andpublication=FR.pdf	3	2	3	0	55	2	6	71	141
/datadrive/data/ESAdocs/federal_register/citation.result.FR.action?federalRegister.volume=2005andfederalRegister.page=53242andpublication=FR.pdf	0	0	0	0	2	0	0	2	2
/datadrive/data/ESAdocs/federal_register/citation.result.FR.action?federalRegister.volume=2005andfederalRegister.page=54106andpublication=FR.pdf	0	1	1	3	19	4	2	30	39
/datadrive/data/ESAdocs/federal_register/citation.result.FR.action?federalRegister.volume=2005andfederalRegister.page=54335andpublication=FR.pdf	0	0	1	0	7	0	0	8	15
/datadrive/data/ESAdocs/federal_register/citation.result.FR.action?federalRegister.volume=2005andfederalRegister.page=56970andpublication=FR.pdf	0	0	2	1	43	0	0	46	151
/datadrive/data/ESAdocs/federal_register/citation.result.FR.action?federalRegister.volume=2005andfederalRegister.page=57888andpublication=FR.pdf	0	0	0	0	2	0	0	2	2
/datadrive/data/ESAdocs/federal_register/citation.result.FR.action?federalRegister.volume=2005andfederalRegister.page=59952andpublication=FR.pdf	0	1	1	1	14	1	2	20	24
/datadrive/data/ESAdocs/federal_register/citation.result.FR.action?federalRegister.volume=2005andfederalRegister.page=60658andpublication=FR.pdf	0	1	1	1	24	1	2	30	38
/datadrive/data/ESAdocs/federal_register/citation.result.FR.action?federalRegister.volume=2005andfederalRegister.page=60886andpublication=FR.pdf	16	0	9	1	95	7	1	129	125
/datadrive/data/ESAdocs/federal_register/citation.result.FR.action?federalRegister.volume=2005andfederalRegister.page=66492andpublication=FR.pdf	2	0	2	0	28	0	0	32	109
/datadrive/data/ESAdocs/federal_register/citation.result.FR.action?federalRegister.volume=2005andfederalRegister.page=66664andpublication=FR.pdf	17	0	5	2	40	8	13	85	59
/datadrive/data/ESAdocs/federal_register/citation.result.FR.action?federalRegister.volume=2005andfederalRegister.page=66842andpublication=FR.pdf	0	0	0	0	3	0	0	3	3
/datadrive/data/ESAdocs/federal_register/citation.result.FR.action?federalRegister.volume=2005andfederalRegister.page=69348andpublication=FR.pdf	0	0	0	0	2	0	1	3	3
/datadrive/data/ESAdocs/federal_register/citation.result.FR.action?federalRegister.volume=2005andfederalRegister.page=69903andpublication=FR.pdf	0	0	0	0	10	0	0	10	10
/datadrive/data/ESAdocs/federal_register/citation.result.FR.action?federalRegister.volume=2005andfederalRegister.page=75546andpublication=FR.pdf	6	0	2	0	30	14	5	57	46
/datadrive/data/ESAdocs/federal_register/citation.result.FR.action?federalRegister.volume=2006andfederalRegister.page=15266andpublication=FR.pdf	13	1	2	0	38	0	0	54	41
/datadrive/data/ESAdocs/federal_register/citation.result.FR.action?federalRegister.volume=2006andfederalRegister.page=17757andpublication=FR.pdf	0	0	0	0	8	0	1	9	10
/datadrive/data/ESAdocs/federal_register/citation.result.FR.action?federalRegister.volume=2006andfederalRegister.page=18456andpublication=FR.pdf	4	1	0	2	21	7	2	37	39
/datadrive/data/ESAdocs/federal_register/citation.result.FR.action?federalRegister.volume=2006andfederalRegister.page=20607andpublication=FR.pdf	0	0	0	1	14	0	0	15	18
/datadrive/data/ESAdocs/federal_register/citation.result.FR.action?federalRegister.volume=2006andfederalRegister.page=20714andpublication=FR.pdf	0	0	0	0	3	0	0	3	3
/datadrive/data/ESAdocs/federal_register/citation.result.FR.action?federalRegister.volume=2006andfederalRegister.page=20717andpublication=FR.pdf	0	0	0	0	2	0	0	2	2
/datadrive/data/ESAdocs/federal_register/citation.result.FR.action?federalRegister.volume=2006andfederalRegister.page=26852andpublication=FR.pdf	0	0	0	0	8	4	2	14	21
/datadrive/data/ESAdocs/federal_register/citation.result.FR.action?federalRegister.volume=2006andfederalRegister.page=28653andpublication=FR.pdf	0	0	0	0	1	0	0	1	2
/datadrive/data/ESAdocs/federal_register/citation.result.FR.action?federalRegister.volume=2006andfederalRegister.page=31137andpublication=FR.pdf	0	0	0	0	4	0	0	4	5
/datadrive/data/ESAdocs/federal_register/citation.result.FR.action?federalRegister.volume=2006andfederalRegister.page=32124andpublication=FR.pdf	0	0	0	0	1	0	1	2	2
/datadrive/data/ESAdocs/federal_register/citation.result.FR.action?federalRegister.volume=2006andfederalRegister.page=32496andpublication=FR.pdf	3	0	1	0	7	0	0	11	8
/datadrive/data/ESAdocs/federal_register/citation.result.FR.action?federalRegister.volume=2006andfederalRegister.page=32746andpublication=FR.pdf	3	0	1	0	18	10	8	40	52
/datadrive/data/ESAdocs/federal_register/citation.result.FR.action?federalRegister.volume=2006andfederalRegister.page=33703andpublication=FR.pdf	0	0	0	0	13	2	1	16	19
/datadrive/data/ESAdocs/federal_register/citation.result.FR.action?federalRegister.volume=2006andfederalRegister.page=33770andpublication=FR.pdf	0	0	0	0	2	0	0	2	3
/datadrive/data/ESAdocs/federal_register/citation.result.FR.action?federalRegister.volume=2006andfederalRegister.page=34196andpublication=FR.pdf	0	0	0	0	29	4	2	35	36
/datadrive/data/ESAdocs/federal_register/citation.result.FR.action?federalRegister.volume=2006andfederalRegister.page=34566andpublication=FR.pdf	1	0	0	0	5	0	0	6	5
/datadrive/data/ESAdocs/federal_register/citation.result.FR.action?federalRegister.volume=2006andfederalRegister.page=35048andpublication=FR.pdf	0	0	0	0	4	0	0	4	38
/datadrive/data/ESAdocs/federal_register/citation.result.FR.action?federalRegister.volume=2006andfederalRegister.page=35286andpublication=FR.pdf	0	0	0	0	3	0	1	4	3
/datadrive/data/ESAdocs/federal_register/citation.result.FR.action?federalRegister.volume=2006andfederalRegister.page=35406andpublication=FR.pdf	0	0	0	0	1	0	0	1	2
/datadrive/data/ESAdocs/federal_register/citation.result.FR.action?federalRegister.volume=2006andfederalRegister.page=37525andpublication=FR.pdf	0	0	0	0	1	0	0	1	2
/datadrive/data/ESAdocs/federal_register/citation.result.FR.action?federalRegister.volume=2006andfederalRegister.page=37881andpublication=FR.pdf	0	0	0	0	3	0	0	3	6
/datadrive/data/ESAdocs/federal_register/citation.result.FR.action?federalRegister.volume=2006andfederalRegister.page=38593andpublication=FR.pdf	1	0	1	0	4	0	0	6	5
/datadrive/data/ESAdocs/federal_register/citation.result.FR.action?federalRegister.volume=2006andfederalRegister.page=39335andpublication=FR.pdf	0	0	0	0	3	0	0	3	3
/datadrive/data/ESAdocs/federal_register/citation.result.FR.action?federalRegister.volume=2006andfederalRegister.page=40588andpublication=FR.pdf	0	0	0	0	13	4	4	21	35
/datadrive/data/ESAdocs/federal_register/citation.result.FR.action?federalRegister.volume=2006andfederalRegister.page=40657andpublication=FR.pdf	4	0	2	2	14	5	1	28	18
/datadrive/data/ESAdocs/federal_register/citation.result.FR.action?federalRegister.volume=2006andfederalRegister.page=41041andpublication=FR.pdf	0	0	0	0	2	0	0	2	2
/datadrive/data/ESAdocs/federal_register/citation.result.FR.action?federalRegister.volume=2006andfederalRegister.page=41410andpublication=FR.pdf	0	0	0	0	2	0	0	2	5
/datadrive/data/ESAdocs/federal_register/citation.result.FR.action?federalRegister.volume=2006andfederalRegister.page=41835andpublication=FR.pdf	0	0	0	0	1	0	0	1	2
/datadrive/data/ESAdocs/federal_register/citation.result.FR.action?federalRegister.volume=2006andfederalRegister.page=42298andpublication=FR.pdf	5	0	0	0	16	0	0	21	18
/datadrive/data/ESAdocs/federal_register/citation.result.FR.action?federalRegister.volume=2006andfederalRegister.page=42410andpublication=FR.pdf	0	0	0	0	2	1	0	3	2
/datadrive/data/ESAdocs/federal_register/citation.result.FR.action?federalRegister.volume=2006andfederalRegister.page=42442andpublication=FR.pdf	1	1	0	0	41	2	2	47	79
/datadrive/data/ESAdocs/federal_register/citation.result.FR.action?federalRegister.volume=2006andfederalRegister.page=42871andpublication=FR.pdf	0	0	0	0	2	0	0	2	2
/datadrive/data/ESAdocs/federal_register/citation.result.FR.action?federalRegister.volume=2006andfederalRegister.page=43410andpublication=FR.pdf	15	5	5	0	23	0	0	48	23
/datadrive/data/ESAdocs/federal_register/citation.result.FR.action?federalRegister.volume=2006andfederalRegister.page=43514andpublication=FR.pdf	0	0	0	0	2	0	0	2	2
/datadrive/data/ESAdocs/federal_register/citation.result.FR.action?federalRegister.volume=2006andfederalRegister.page=44960andpublication=FR.pdf	0	0	0	0	6	2	0	8	7
/datadrive/data/ESAdocs/federal_register/citation.result.FR.action?federalRegister.volume=2006andfederalRegister.page=44966andpublication=FR.pdf	1	0	0	0	7	0	0	8	11
/datadrive/data/ESAdocs/federal_register/citation.result.FR.action?federalRegister.volume=2006andfederalRegister.page=44976andpublication=FR.pdf	0	0	0	0	3	0	0	3	5
/datadrive/data/ESAdocs/federal_register/citation.result.FR.action?federalRegister.volume=2006andfederalRegister.page=46864andpublication=FR.pdf	0	0	0	0	5	0	0	5	7
/datadrive/data/ESAdocs/federal_register/citation.result.FR.action?federalRegister.volume=2006andfederalRegister.page=46994andpublication=FR.pdf	0	2	2	1	29	0	0	34	62
/datadrive/data/ESAdocs/federal_register/citation.result.FR.action?federalRegister.volume=2006andfederalRegister.page=48554andpublication=FR.pdf	0	0	0	0	1	0	1	2	2
/datadrive/data/ESAdocs/federal_register/citation.result.FR.action?federalRegister.volume=2006andfederalRegister.page=48883andpublication=FR.pdf	0	0	4	0	14	1	0	19	17
/datadrive/data/ESAdocs/federal_register/citation.result.FR.action?federalRegister.volume=2006andfederalRegister.page=52339andpublication=FR.pdf	1	0	0	0	2	0	0	3	2
/datadrive/data/ESAdocs/federal_register/citation.result.FR.action?federalRegister.volume=2006andfederalRegister.page=52567andpublication=FR.pdf	0	0	0	0	2	0	0	2	2
/datadrive/data/ESAdocs/federal_register/citation.result.FR.action?federalRegister.volume=2006andfederalRegister.page=52816andpublication=FR.pdf	0	0	0	0	2	0	0	2	3
/datadrive/data/ESAdocs/federal_register/citation.result.FR.action?federalRegister.volume=2006andfederalRegister.page=53127andpublication=FR.pdf	0	0	0	0	2	0	0	2	3
/datadrive/data/ESAdocs/federal_register/citation.result.FR.action?federalRegister.volume=2006andfederalRegister.page=53355andpublication=FR.pdf	0	0	0	0	4	0	0	4	7
/datadrive/data/ESAdocs/federal_register/citation.result.FR.action?federalRegister.volume=2006andfederalRegister.page=53589andpublication=FR.pdf	0	0	1	0	10	0	0	11	17
/datadrive/data/ESAdocs/federal_register/citation.result.FR.action?federalRegister.volume=2006andfederalRegister.page=53756andpublication=FR.pdf	15	4	17	21	75	10	9	151	81
/datadrive/data/ESAdocs/federal_register/citation.result.FR.action?federalRegister.volume=2006andfederalRegister.page=53838andpublication=FR.pdf	1	1	1	0	24	0	0	27	115
/datadrive/data/ESAdocs/federal_register/citation.result.FR.action?federalRegister.volume=2006andfederalRegister.page=54681andpublication=FR.pdf	0	0	0	0	2	0	0	2	2
/datadrive/data/ESAdocs/federal_register/citation.result.FR.action?federalRegister.volume=2006andfederalRegister.page=54682andpublication=FR.pdf	0	0	0	0	2	0	0	2	2
/datadrive/data/ESAdocs/federal_register/citation.result.FR.action?federalRegister.volume=2006andfederalRegister.page=54837andpublication=FR.pdf	0	0	0	0	2	1	0	3	2
/datadrive/data/ESAdocs/federal_register/citation.result.FR.action?federalRegister.volume=2006andfederalRegister.page=54838andpublication=FR.pdf	0	0	0	0	2	1	0	3	2
/datadrive/data/ESAdocs/federal_register/citation.result.FR.action?federalRegister.volume=2006andfederalRegister.page=55005andpublication=FR.pdf	0	0	0	0	2	0	1	3	3
/datadrive/data/ESAdocs/federal_register/citation.result.FR.action?federalRegister.volume=2006andfederalRegister.page=55212andpublication=FR.pdf	0	0	0	0	3	0	0	3	3
/datadrive/data/ESAdocs/federal_register/citation.result.FR.action?federalRegister.volume=2006andfederalRegister.page=55508andpublication=FR.pdf	0	0	0	0	2	0	0	2	2
/datadrive/data/ESAdocs/federal_register/citation.result.FR.action?federalRegister.volume=2006andfederalRegister.page=56085andpublication=FR.pdf	1	0	0	1	5	0	0	7	10
/datadrive/data/ESAdocs/federal_register/citation.result.FR.action?federalRegister.volume=2006andfederalRegister.page=56094andpublication=FR.pdf	0	0	0	4	4	0	0	8	5
/datadrive/data/ESAdocs/federal_register/citation.result.FR.action?federalRegister.volume=2006andfederalRegister.page=56228andpublication=FR.pdf	10	2	4	3	23	4	0	46	30
/datadrive/data/ESAdocs/federal_register/citation.result.FR.action?federalRegister.volume=2006andfederalRegister.page=56545andpublication=FR.pdf	0	0	0	1	2	0	0	3	3
/datadrive/data/ESAdocs/federal_register/citation.result.FR.action?federalRegister.volume=2006andfederalRegister.page=56547andpublication=FR.pdf	0	0	0	1	1	0	0	2	2
/datadrive/data/ESAdocs/federal_register/citation.result.FR.action?federalRegister.volume=2006andfederalRegister.page=57003andpublication=FR.pdf	0	0	0	0	2	0	1	3	2
/datadrive/data/ESAdocs/federal_register/citation.result.FR.action?federalRegister.volume=2006andfederalRegister.page=57004andpublication=FR.pdf	0	0	0	0	2	0	0	2	2
/datadrive/data/ESAdocs/federal_register/citation.result.FR.action?federalRegister.volume=2006andfederalRegister.page=57557andpublication=FR.pdf	0	0	0	0	1	0	0	1	2
/datadrive/data/ESAdocs/federal_register/citation.result.FR.action?federalRegister.volume=2006andfederalRegister.page=57558andpublication=FR.pdf	0	0	0	0	3	0	1	4	3
/datadrive/data/ESAdocs/federal_register/citation.result.FR.action?federalRegister.volume=2006andfederalRegister.page=58176andpublication=FR.pdf	4	1	0	4	31	0	0	40	57
/datadrive/data/ESAdocs/federal_register/citation.result.FR.action?federalRegister.volume=2006andfederalRegister.page=58340andpublication=FR.pdf	0	0	0	0	16	0	0	16	24
/datadrive/data/ESAdocs/federal_register/citation.result.FR.action?federalRegister.volume=2006andfederalRegister.page=58363andpublication=FR.pdf	0	0	0	0	1	0	0	1	2
/datadrive/data/ESAdocs/federal_register/citation.result.FR.action?federalRegister.volume=2006andfederalRegister.page=58426andpublication=FR.pdf	0	0	0	0	1	0	0	1	2
/datadrive/data/ESAdocs/federal_register/citation.result.FR.action?federalRegister.volume=2006andfederalRegister.page=58954andpublication=FR.pdf	0	0	0	1	15	5	4	25	39
/datadrive/data/ESAdocs/federal_register/citation.result.FR.action?federalRegister.volume=2006andfederalRegister.page=60238andpublication=FR.pdf	0	1	1	0	25	0	0	27	134
/datadrive/data/ESAdocs/federal_register/citation.result.FR.action?federalRegister.volume=2006andfederalRegister.page=61501andpublication=FR.pdf	0	0	0	0	2	0	0	2	2
/datadrive/data/ESAdocs/federal_register/citation.result.FR.action?federalRegister.volume=2006andfederalRegister.page=61502andpublication=FR.pdf	0	0	0	0	2	0	0	2	2
/datadrive/data/ESAdocs/federal_register/citation.result.FR.action?federalRegister.volume=2006andfederalRegister.page=61546andpublication=FR.pdf	1	0	0	2	18	2	0	23	34
/datadrive/data/ESAdocs/federal_register/citation.result.FR.action?federalRegister.volume=2006andfederalRegister.page=63862andpublication=FR.pdf	1	1	2	0	39	0	0	43	117
/datadrive/data/ESAdocs/federal_register/citation.result.FR.action?federalRegister.volume=2006andfederalRegister.page=63980andpublication=FR.pdf	0	0	1	0	19	1	1	22	24
/datadrive/data/ESAdocs/federal_register/citation.result.FR.action?federalRegister.volume=2006andfederalRegister.page=65662andpublication=FR.pdf	0	0	0	1	17	0	0	18	23
/datadrive/data/ESAdocs/federal_register/citation.result.FR.action?federalRegister.volume=2006andfederalRegister.page=65830andpublication=FR.pdf	0	0	0	0	3	0	0	3	3
/datadrive/data/ESAdocs/federal_register/citation.result.FR.action?federalRegister.volume=2006andfederalRegister.page=66008andpublication=FR.pdf	2	0	1	0	35	0	1	39	55
/datadrive/data/ESAdocs/federal_register/citation.result.FR.action?federalRegister.volume=2006andfederalRegister.page=66292andpublication=FR.pdf	0	0	2	0	6	1	0	9	7
/datadrive/data/ESAdocs/federal_register/citation.result.FR.action?federalRegister.volume=2006andfederalRegister.page=66298andpublication=FR.pdf	0	1	0	0	4	0	1	6	4
/datadrive/data/ESAdocs/federal_register/citation.result.FR.action?federalRegister.volume=2006andfederalRegister.page=66341andpublication=FR.pdf	0	0	0	0	3	0	0	3	3
/datadrive/data/ESAdocs/federal_register/citation.result.FR.action?federalRegister.volume=2006andfederalRegister.page=66374andpublication=FR.pdf	1	0	4	5	24	5	0	39	51
/datadrive/data/ESAdocs/federal_register/citation.result.FR.action?federalRegister.volume=2006andfederalRegister.page=67530andpublication=FR.pdf	0	1	0	0	8	0	0	9	11
/datadrive/data/ESAdocs/federal_register/citation.result.FR.action?federalRegister.volume=2006andfederalRegister.page=67712andpublication=FR.pdf	0	0	2	1	20	1	0	24	44
/datadrive/data/ESAdocs/federal_register/citation.result.FR.action?federalRegister.volume=2006andfederalRegister.page=68914andpublication=FR.pdf	0	0	4	0	37	5	3	49	83
/datadrive/data/ESAdocs/federal_register/citation.result.FR.action?federalRegister.volume=2006andfederalRegister.page=69054andpublication=FR.pdf	0	0	0	0	14	2	9	25	17
/datadrive/data/ESAdocs/federal_register/citation.result.FR.action?federalRegister.volume=2006andfederalRegister.page=70479andpublication=FR.pdf	2	0	1	2	5	0	0	10	5
/datadrive/data/ESAdocs/federal_register/citation.result.FR.action?federalRegister.volume=2006andfederalRegister.page=7118andpublication=FR.pdf	0	0	0	0	69	0	0	69	200
/datadrive/data/ESAdocs/federal_register/citation.result.FR.action?federalRegister.volume=2006andfederalRegister.page=74592andpublication=FR.pdf	3	0	5	2	17	0	0	27	25
/datadrive/data/ESAdocs/federal_register/citation.result.FR.action?federalRegister.volume=2006andfederalRegister.page=75189andpublication=FR.pdf	1	0	0	4	18	0	0	23	27
/datadrive/data/ESAdocs/federal_register/citation.result.FR.action?federalRegister.volume=2006andfederalRegister.page=75215andpublication=FR.pdf	0	0	0	0	4	1	0	5	6
/datadrive/data/ESAdocs/federal_register/citation.result.FR.action?federalRegister.volume=2006andfederalRegister.page=76359andpublication=FR.pdf	0	0	0	0	3	0	0	3	3
/datadrive/data/ESAdocs/federal_register/citation.result.FR.action?federalRegister.volume=2006andfederalRegister.page=77058andpublication=FR.pdf	0	0	0	0	2	0	0	2	2
/datadrive/data/ESAdocs/federal_register/citation.result.FR.action?federalRegister.volume=2006andfederalRegister.page=77972andpublication=FR.pdf	4	0	4	1	23	0	0	32	42
/datadrive/data/ESAdocs/federal_register/citation.result.FR.action?federalRegister.volume=2006andfederalRegister.page=78452andpublication=FR.pdf	1	0	0	0	3	0	0	4	3
/datadrive/data/ESAdocs/federal_register/citation.result.FR.action?federalRegister.volume=2006andfederalRegister.page=8258andpublication=FR.pdf	0	0	0	0	1	0	0	1	7
/datadrive/data/ESAdocs/federal_register/citation.result.FR.action?federalRegister.volume=2006andfederalRegister.page=834andpublication=FR.pdf	0	3	0	0	28	2	5	38	30
/datadrive/data/ESAdocs/federal_register/citation.result.FR.action?federalRegister.volume=2007andfederalRegister.page=10547andpublication=FR.pdf	0	0	0	0	2	0	0	2	4
/datadrive/data/ESAdocs/federal_register/citation.result.FR.action?federalRegister.volume=2007andfederalRegister.page=10551andpublication=FR.pdf	0	0	0	0	1	0	0	1	2
/datadrive/data/ESAdocs/federal_register/citation.result.FR.action?federalRegister.volume=2007andfederalRegister.page=1064andpublication=FR.pdf	0	0	0	0	25	0	0	25	37
/datadrive/data/ESAdocs/federal_register/citation.result.FR.action?federalRegister.volume=2007andfederalRegister.page=11374andpublication=FR.pdf	0	0	0	0	1	0	0	1	2
/datadrive/data/ESAdocs/federal_register/citation.result.FR.action?federalRegister.volume=2007andfederalRegister.page=11376andpublication=FR.pdf	0	0	0	0	2	0	0	2	2
/datadrive/data/ESAdocs/federal_register/citation.result.FR.action?federalRegister.volume=2007andfederalRegister.page=11819andpublication=FR.pdf	0	0	0	0	2	0	0	2	4
/datadrive/data/ESAdocs/federal_register/citation.result.FR.action?federalRegister.volume=2007andfederalRegister.page=1186andpublication=FR.pdf	0	0	0	0	4	0	0	4	4
/datadrive/data/ESAdocs/federal_register/citation.result.FR.action?federalRegister.volume=2007andfederalRegister.page=11946andpublication=FR.pdf	0	0	0	2	17	0	0	19	44
/datadrive/data/ESAdocs/federal_register/citation.result.FR.action?federalRegister.volume=2007andfederalRegister.page=12585andpublication=FR.pdf	0	0	0	0	3	1	1	5	5
/datadrive/data/ESAdocs/federal_register/citation.result.FR.action?federalRegister.volume=2007andfederalRegister.page=13027andpublication=FR.pdf	0	0	0	0	10	0	0	10	15
/datadrive/data/ESAdocs/federal_register/citation.result.FR.action?federalRegister.volume=2007andfederalRegister.page=13061andpublication=FR.pdf	0	0	0	0	6	0	0	6	8
/datadrive/data/ESAdocs/federal_register/citation.result.FR.action?federalRegister.volume=2007andfederalRegister.page=13356andpublication=FR.pdf	16	1	5	0	49	19	9	99	68
/datadrive/data/ESAdocs/federal_register/citation.result.FR.action?federalRegister.volume=2007andfederalRegister.page=14132andpublication=FR.pdf	0	0	0	0	2	0	0	2	2
/datadrive/data/ESAdocs/federal_register/citation.result.FR.action?federalRegister.volume=2007andfederalRegister.page=14328andpublication=FR.pdf	7	0	1	1	19	0	0	28	40
/datadrive/data/ESAdocs/federal_register/citation.result.FR.action?federalRegister.volume=2007andfederalRegister.page=14760andpublication=FR.pdf	0	0	0	0	2	0	0	2	2
/datadrive/data/ESAdocs/federal_register/citation.result.FR.action?federalRegister.volume=2007andfederalRegister.page=14866andpublication=FR.pdf	31	9	4	0	63	0	0	107	74
/datadrive/data/ESAdocs/federal_register/citation.result.FR.action?federalRegister.volume=2007andfederalRegister.page=15857andpublication=FR.pdf	0	0	0	0	2	0	0	2	3
/datadrive/data/ESAdocs/federal_register/citation.result.FR.action?federalRegister.volume=2007andfederalRegister.page=1622andpublication=FR.pdf	12	1	2	8	23	3	0	49	24
/datadrive/data/ESAdocs/federal_register/citation.result.FR.action?federalRegister.volume=2007andfederalRegister.page=16284andpublication=FR.pdf	0	0	0	0	2	0	0	2	3
/datadrive/data/ESAdocs/federal_register/citation.result.FR.action?federalRegister.volume=2007andfederalRegister.page=16756andpublication=FR.pdf	0	0	0	0	4	0	0	4	6
/datadrive/data/ESAdocs/federal_register/citation.result.FR.action?federalRegister.volume=2007andfederalRegister.page=18518andpublication=FR.pdf	3	0	1	2	20	2	1	29	37
/datadrive/data/ESAdocs/federal_register/citation.result.FR.action?federalRegister.volume=2007andfederalRegister.page=19015andpublication=FR.pdf	0	0	0	0	2	0	0	2	2
/datadrive/data/ESAdocs/federal_register/citation.result.FR.action?federalRegister.volume=2007andfederalRegister.page=19549andpublication=FR.pdf	0	0	0	0	2	0	0	2	3
/datadrive/data/ESAdocs/federal_register/citation.result.FR.action?federalRegister.volume=2007andfederalRegister.page=20134andpublication=FR.pdf	0	0	0	0	3	0	0	3	3
/datadrive/data/ESAdocs/federal_register/citation.result.FR.action?federalRegister.volume=2007andfederalRegister.page=20557andpublication=FR.pdf	0	0	0	0	0	0	0	0	2
/datadrive/data/ESAdocs/federal_register/citation.result.FR.action?federalRegister.volume=2007andfederalRegister.page=20865andpublication=FR.pdf	0	0	0	0	2	0	0	2	2
/datadrive/data/ESAdocs/federal_register/citation.result.FR.action?federalRegister.volume=2007andfederalRegister.page=20866andpublication=FR.pdf	0	0	0	0	3	0	0	3	3
/datadrive/data/ESAdocs/federal_register/citation.result.FR.action?federalRegister.volume=2007andfederalRegister.page=2301andpublication=FR.pdf	0	0	0	0	2	0	1	3	2
/datadrive/data/ESAdocs/federal_register/citation.result.FR.action?federalRegister.volume=2007andfederalRegister.page=24598andpublication=FR.pdf	0	0	0	0	1	0	0	1	2
/datadrive/data/ESAdocs/federal_register/citation.result.FR.action?federalRegister.volume=2007andfederalRegister.page=28016andpublication=FR.pdf	0	0	0	0	2	0	0	2	3
/datadrive/data/ESAdocs/federal_register/citation.result.FR.action?federalRegister.volume=2007andfederalRegister.page=29544andpublication=FR.pdf	0	0	0	0	2	0	0	2	2
/datadrive/data/ESAdocs/federal_register/citation.result.FR.action?federalRegister.volume=2007andfederalRegister.page=29933andpublication=FR.pdf	1	0	0	2	6	0	0	9	9
/datadrive/data/ESAdocs/federal_register/citation.result.FR.action?federalRegister.volume=2007andfederalRegister.page=30326andpublication=FR.pdf	0	0	0	0	3	0	0	3	6
/datadrive/data/ESAdocs/federal_register/citation.result.FR.action?federalRegister.volume=2007andfederalRegister.page=30819andpublication=FR.pdf	0	0	0	0	2	0	0	2	2
/datadrive/data/ESAdocs/federal_register/citation.result.FR.action?federalRegister.volume=2007andfederalRegister.page=30820andpublication=FR.pdf	1	0	1	0	2	0	0	4	2
/datadrive/data/ESAdocs/federal_register/citation.result.FR.action?federalRegister.volume=2007andfederalRegister.page=31048andpublication=FR.pdf	0	0	0	0	2	0	0	2	2
/datadrive/data/ESAdocs/federal_register/citation.result.FR.action?federalRegister.volume=2007andfederalRegister.page=31250andpublication=FR.pdf	0	0	0	0	3	4	3	10	7
/datadrive/data/ESAdocs/federal_register/citation.result.FR.action?federalRegister.volume=2007andfederalRegister.page=31338andpublication=FR.pdf	0	0	0	0	1	0	0	1	2
/datadrive/data/ESAdocs/federal_register/citation.result.FR.action?federalRegister.volume=2007andfederalRegister.page=321andpublication=FR.pdf	0	0	1	0	3	0	0	4	5
/datadrive/data/ESAdocs/federal_register/citation.result.FR.action?federalRegister.volume=2007andfederalRegister.page=32305andpublication=FR.pdf	0	0	0	0	2	0	0	2	2
/datadrive/data/ESAdocs/federal_register/citation.result.FR.action?federalRegister.volume=2007andfederalRegister.page=32516andpublication=FR.pdf	0	0	0	0	26	0	0	26	68
/datadrive/data/ESAdocs/federal_register/citation.result.FR.action?federalRegister.volume=2007andfederalRegister.page=32857andpublication=FR.pdf	0	0	0	0	2	0	0	2	2
/datadrive/data/ESAdocs/federal_register/citation.result.FR.action?federalRegister.volume=2007andfederalRegister.page=33715andpublication=FR.pdf	0	0	0	0	7	3	3	13	18
/datadrive/data/ESAdocs/federal_register/citation.result.FR.action?federalRegister.volume=2007andfederalRegister.page=3379andpublication=FR.pdf	2	1	1	1	4	0	0	9	4
/datadrive/data/ESAdocs/federal_register/citation.result.FR.action?federalRegister.volume=2007andfederalRegister.page=33808andpublication=FR.pdf	0	0	0	0	21	3	0	24	36
/datadrive/data/ESAdocs/federal_register/citation.result.FR.action?federalRegister.volume=2007andfederalRegister.page=34216andpublication=FR.pdf	0	0	0	0	4	0	1	5	10
/datadrive/data/ESAdocs/federal_register/citation.result.FR.action?federalRegister.volume=2007andfederalRegister.page=34657andpublication=FR.pdf	0	0	0	0	4	0	0	4	5
/datadrive/data/ESAdocs/federal_register/citation.result.FR.action?federalRegister.volume=2007andfederalRegister.page=35025andpublication=FR.pdf	0	0	0	0	3	0	0	3	4
/datadrive/data/ESAdocs/federal_register/citation.result.FR.action?federalRegister.volume=2007andfederalRegister.page=35253andpublication=FR.pdf	0	0	0	1	2	0	0	3	2
/datadrive/data/ESAdocs/federal_register/citation.result.FR.action?federalRegister.volume=2007andfederalRegister.page=36635andpublication=FR.pdf	0	0	0	0	11	2	0	13	12
/datadrive/data/ESAdocs/federal_register/citation.result.FR.action?federalRegister.volume=2007andfederalRegister.page=36939andpublication=FR.pdf	1	0	0	0	3	0	0	4	4
/datadrive/data/ESAdocs/federal_register/citation.result.FR.action?federalRegister.volume=2007andfederalRegister.page=36942andpublication=FR.pdf	3	2	2	0	6	0	0	13	8
/datadrive/data/ESAdocs/federal_register/citation.result.FR.action?federalRegister.volume=2007andfederalRegister.page=37540andpublication=FR.pdf	0	0	0	0	2	0	1	3	3
/datadrive/data/ESAdocs/federal_register/citation.result.FR.action?federalRegister.volume=2007andfederalRegister.page=37695andpublication=FR.pdf	0	0	0	0	2	0	0	2	3
/datadrive/data/ESAdocs/federal_register/citation.result.FR.action?federalRegister.volume=2007andfederalRegister.page=39248andpublication=FR.pdf	0	0	0	0	17	3	7	27	37
/datadrive/data/ESAdocs/federal_register/citation.result.FR.action?federalRegister.volume=2007andfederalRegister.page=4018andpublication=FR.pdf	0	0	0	0	2	0	0	2	2
/datadrive/data/ESAdocs/federal_register/citation.result.FR.action?federalRegister.volume=2007andfederalRegister.page=40956andpublication=FR.pdf	2	35	1	1	23	0	0	62	54
/datadrive/data/ESAdocs/federal_register/citation.result.FR.action?federalRegister.volume=2007andfederalRegister.page=41258andpublication=FR.pdf	0	0	0	0	11	0	0	11	27
/datadrive/data/ESAdocs/federal_register/citation.result.FR.action?federalRegister.volume=2007andfederalRegister.page=41348andpublication=FR.pdf	0	0	0	0	2	0	0	2	3
/datadrive/data/ESAdocs/federal_register/citation.result.FR.action?federalRegister.volume=2007andfederalRegister.page=41350andpublication=FR.pdf	0	0	0	0	1	0	0	1	2
/datadrive/data/ESAdocs/federal_register/citation.result.FR.action?federalRegister.volume=2007andfederalRegister.page=41679andpublication=FR.pdf	2	1	1	0	14	7	5	30	23
/datadrive/data/ESAdocs/federal_register/citation.result.FR.action?federalRegister.volume=2007andfederalRegister.page=42425andpublication=FR.pdf	0	0	0	0	1	0	0	1	2
/datadrive/data/ESAdocs/federal_register/citation.result.FR.action?federalRegister.volume=2007andfederalRegister.page=42426andpublication=FR.pdf	0	0	0	0	2	1	0	3	2
/datadrive/data/ESAdocs/federal_register/citation.result.FR.action?federalRegister.volume=2007andfederalRegister.page=4330andpublication=FR.pdf	0	0	1	0	29	0	0	30	41
/datadrive/data/ESAdocs/federal_register/citation.result.FR.action?federalRegister.volume=2007andfederalRegister.page=44232andpublication=FR.pdf	0	0	4	1	24	0	0	29	52
/datadrive/data/ESAdocs/federal_register/citation.result.FR.action?federalRegister.volume=2007andfederalRegister.page=47064andpublication=FR.pdf	0	0	0	0	2	0	0	2	2
/datadrive/data/ESAdocs/federal_register/citation.result.FR.action?federalRegister.volume=2007andfederalRegister.page=48178andpublication=FR.pdf	0	0	1	1	22	0	0	24	42
/datadrive/data/ESAdocs/federal_register/citation.result.FR.action?federalRegister.volume=2007andfederalRegister.page=49212andpublication=FR.pdf	1	0	3	0	16	0	0	20	17
/datadrive/data/ESAdocs/federal_register/citation.result.FR.action?federalRegister.volume=2007andfederalRegister.page=50918andpublication=FR.pdf	1	0	0	0	10	1	2	14	12
/datadrive/data/ESAdocs/federal_register/citation.result.FR.action?federalRegister.volume=2007andfederalRegister.page=50929andpublication=FR.pdf	0	0	0	0	0	0	0	0	2
/datadrive/data/ESAdocs/federal_register/citation.result.FR.action?federalRegister.volume=2007andfederalRegister.page=51102andpublication=FR.pdf	2	0	1	0	28	5	2	38	52
/datadrive/data/ESAdocs/federal_register/citation.result.FR.action?federalRegister.volume=2007andfederalRegister.page=51242andpublication=FR.pdf	0	0	0	0	2	0	0	2	2
/datadrive/data/ESAdocs/federal_register/citation.result.FR.action?federalRegister.volume=2007andfederalRegister.page=51244andpublication=FR.pdf	0	0	0	0	2	0	0	2	2
/datadrive/data/ESAdocs/federal_register/citation.result.FR.action?federalRegister.volume=2007andfederalRegister.page=51461andpublication=FR.pdf	0	0	0	0	2	0	0	2	2
/datadrive/data/ESAdocs/federal_register/citation.result.FR.action?federalRegister.volume=2007andfederalRegister.page=52386andpublication=FR.pdf	0	0	0	0	2	0	0	2	2
/datadrive/data/ESAdocs/federal_register/citation.result.FR.action?federalRegister.volume=2007andfederalRegister.page=52434andpublication=FR.pdf	0	0	0	0	16	4	2	22	29
/datadrive/data/ESAdocs/federal_register/citation.result.FR.action?federalRegister.volume=2007andfederalRegister.page=52575andpublication=FR.pdf	0	0	0	0	2	0	0	2	2
/datadrive/data/ESAdocs/federal_register/citation.result.FR.action?federalRegister.volume=2007andfederalRegister.page=53211andpublication=FR.pdf	1	0	0	1	10	2	0	14	12
/datadrive/data/ESAdocs/federal_register/citation.result.FR.action?federalRegister.volume=2007andfederalRegister.page=53749andpublication=FR.pdf	0	0	0	0	3	0	0	3	3
/datadrive/data/ESAdocs/federal_register/citation.result.FR.action?federalRegister.volume=2007andfederalRegister.page=54057andpublication=FR.pdf	0	0	0	0	3	0	0	3	3
/datadrive/data/ESAdocs/federal_register/citation.result.FR.action?federalRegister.volume=2007andfederalRegister.page=54059andpublication=FR.pdf	0	0	0	0	2	0	0	2	2
/datadrive/data/ESAdocs/federal_register/citation.result.FR.action?federalRegister.volume=2007andfederalRegister.page=54061andpublication=FR.pdf	0	0	0	0	1	0	0	1	2
/datadrive/data/ESAdocs/federal_register/citation.result.FR.action?federalRegister.volume=2007andfederalRegister.page=54279andpublication=FR.pdf	0	0	0	0	2	0	0	2	2
/datadrive/data/ESAdocs/federal_register/citation.result.FR.action?federalRegister.volume=2007andfederalRegister.page=54377andpublication=FR.pdf	0	0	0	6	6	0	0	12	8
/datadrive/data/ESAdocs/federal_register/citation.result.FR.action?federalRegister.volume=2007andfederalRegister.page=54922andpublication=FR.pdf	1	0	0	0	2	0	0	3	2
/datadrive/data/ESAdocs/federal_register/citation.result.FR.action?federalRegister.volume=2007andfederalRegister.page=54984andpublication=FR.pdf	0	0	2	0	20	2	0	24	27
/datadrive/data/ESAdocs/federal_register/citation.result.FR.action?federalRegister.volume=2007andfederalRegister.page=5552andpublication=FR.pdf	2	0	0	1	23	5	0	31	30
/datadrive/data/ESAdocs/federal_register/citation.result.FR.action?federalRegister.volume=2007andfederalRegister.page=56787andpublication=FR.pdf	0	0	0	0	1	0	0	1	2
/datadrive/data/ESAdocs/federal_register/citation.result.FR.action?federalRegister.volume=2007andfederalRegister.page=56979andpublication=FR.pdf	0	0	0	0	1	0	0	1	2
/datadrive/data/ESAdocs/federal_register/citation.result.FR.action?federalRegister.volume=2007andfederalRegister.page=58111andpublication=FR.pdf	1	1	0	0	2	0	0	4	2
/datadrive/data/ESAdocs/federal_register/citation.result.FR.action?federalRegister.volume=2007andfederalRegister.page=5856andpublication=FR.pdf	0	0	0	0	30	2	1	33	58
/datadrive/data/ESAdocs/federal_register/citation.result.FR.action?federalRegister.volume=2007andfederalRegister.page=59301andpublication=FR.pdf	0	0	0	0	2	0	0	2	2
/datadrive/data/ESAdocs/federal_register/citation.result.FR.action?federalRegister.volume=2007andfederalRegister.page=60068andpublication=FR.pdf	0	0	0	1	18	7	6	32	48
/datadrive/data/ESAdocs/federal_register/citation.result.FR.action?federalRegister.volume=2007andfederalRegister.page=60410andpublication=FR.pdf	1	0	1	2	28	2	0	34	42
/datadrive/data/ESAdocs/federal_register/citation.result.FR.action?federalRegister.volume=2007andfederalRegister.page=6052andpublication=FR.pdf	15	1	1	0	47	0	0	64	53
/datadrive/data/ESAdocs/federal_register/citation.result.FR.action?federalRegister.volume=2007andfederalRegister.page=6106andpublication=FR.pdf	20	4	4	0	32	0	0	60	35
/datadrive/data/ESAdocs/federal_register/citation.result.FR.action?federalRegister.volume=2007andfederalRegister.page=62254andpublication=FR.pdf	0	0	0	0	2	0	0	2	3
/datadrive/data/ESAdocs/federal_register/citation.result.FR.action?federalRegister.volume=2007andfederalRegister.page=62485andpublication=FR.pdf	0	0	0	0	2	0	0	2	2
/datadrive/data/ESAdocs/federal_register/citation.result.FR.action?federalRegister.volume=2007andfederalRegister.page=62736andpublication=FR.pdf	0	0	1	0	21	0	1	23	32
/datadrive/data/ESAdocs/federal_register/citation.result.FR.action?federalRegister.volume=2007andfederalRegister.page=62992andpublication=FR.pdf	3	0	1	1	26	2	1	34	34
/datadrive/data/ESAdocs/federal_register/citation.result.FR.action?federalRegister.volume=2007andfederalRegister.page=63123andpublication=FR.pdf	0	0	0	0	14	0	0	14	18
/datadrive/data/ESAdocs/federal_register/citation.result.FR.action?federalRegister.volume=2007andfederalRegister.page=64286andpublication=FR.pdf	2	0	1	0	26	17	12	58	56
/datadrive/data/ESAdocs/federal_register/citation.result.FR.action?federalRegister.volume=2007andfederalRegister.page=64585andpublication=FR.pdf	0	0	0	0	3	0	0	3	3
/datadrive/data/ESAdocs/federal_register/citation.result.FR.action?federalRegister.volume=2007andfederalRegister.page=65058andpublication=FR.pdf	0	0	0	0	2	0	0	2	2
/datadrive/data/ESAdocs/federal_register/citation.result.FR.action?federalRegister.volume=2007andfederalRegister.page=65763andpublication=FR.pdf	0	0	0	0	1	0	0	1	2
/datadrive/data/ESAdocs/federal_register/citation.result.FR.action?federalRegister.volume=2007andfederalRegister.page=6699andpublication=FR.pdf	0	0	0	0	4	3	3	10	5
/datadrive/data/ESAdocs/federal_register/citation.result.FR.action?federalRegister.volume=2007andfederalRegister.page=69034andpublication=FR.pdf	12	4	21	14	66	10	6	133	74
/datadrive/data/ESAdocs/federal_register/citation.result.FR.action?federalRegister.volume=2007andfederalRegister.page=70602andpublication=FR.pdf	0	0	0	1	2	0	0	3	2
/datadrive/data/ESAdocs/federal_register/citation.result.FR.action?federalRegister.volume=2007andfederalRegister.page=70648andpublication=FR.pdf	3	0	3	1	36	1	3	47	68
/datadrive/data/ESAdocs/federal_register/citation.result.FR.action?federalRegister.volume=2007andfederalRegister.page=7064andpublication=FR.pdf	0	0	0	0	5	0	0	5	5
/datadrive/data/ESAdocs/federal_register/citation.result.FR.action?federalRegister.volume=2007andfederalRegister.page=71040andpublication=FR.pdf	0	0	0	0	12	7	9	28	16
/datadrive/data/ESAdocs/federal_register/citation.result.FR.action?federalRegister.volume=2007andfederalRegister.page=71298andpublication=FR.pdf	5	0	1	2	16	0	0	24	18
/datadrive/data/ESAdocs/federal_register/citation.result.FR.action?federalRegister.volume=2007andfederalRegister.page=72010andpublication=FR.pdf	3	0	1	0	56	1	0	61	205
/datadrive/data/ESAdocs/federal_register/citation.result.FR.action?federalRegister.volume=2007andfederalRegister.page=73092andpublication=FR.pdf	1	0	2	1	25	1	0	30	88
/datadrive/data/ESAdocs/federal_register/citation.result.FR.action?federalRegister.volume=2007andfederalRegister.page=7381andpublication=FR.pdf	0	0	0	0	2	0	0	2	2
/datadrive/data/ESAdocs/federal_register/citation.result.FR.action?federalRegister.volume=2007andfederalRegister.page=7843andpublication=FR.pdf	7	1	2	1	9	0	0	20	10
/datadrive/data/ESAdocs/federal_register/citation.result.FR.action?federalRegister.volume=2007andfederalRegister.page=9913andpublication=FR.pdf	0	0	0	0	3	0	0	3	5
/datadrive/data/ESAdocs/federal_register/citation.result.FR.action?federalRegister.volume=2008andfederalRegister.page=10514andpublication=FR.pdf	24	6	4	0	42	0	0	76	48
/datadrive/data/ESAdocs/federal_register/citation.result.FR.action?federalRegister.volume=2008andfederalRegister.page=10860andpublication=FR.pdf	1	1	0	0	26	0	0	28	38
/datadrive/data/ESAdocs/federal_register/citation.result.FR.action?federalRegister.volume=2008andfederalRegister.page=11849andpublication=FR.pdf	0	0	0	0	3	0	0	3	3
/datadrive/data/ESAdocs/federal_register/citation.result.FR.action?federalRegister.volume=2008andfederalRegister.page=11870andpublication=FR.pdf	1	0	0	0	1	0	0	2	2
/datadrive/data/ESAdocs/federal_register/citation.result.FR.action?federalRegister.volume=2008andfederalRegister.page=11945andpublication=FR.pdf	0	0	0	0	4	0	0	4	6
/datadrive/data/ESAdocs/federal_register/citation.result.FR.action?federalRegister.volume=2008andfederalRegister.page=12067andpublication=FR.pdf	0	0	1	0	1	0	0	2	2
/datadrive/data/ESAdocs/federal_register/citation.result.FR.action?federalRegister.volume=2008andfederalRegister.page=12929andpublication=FR.pdf	1	0	0	0	10	0	0	11	13
/datadrive/data/ESAdocs/federal_register/citation.result.FR.action?federalRegister.volume=2008andfederalRegister.page=12941andpublication=FR.pdf	0	0	0	0	2	0	0	2	5
/datadrive/data/ESAdocs/federal_register/citation.result.FR.action?federalRegister.volume=2008andfederalRegister.page=1312andpublication=FR.pdf	1	0	0	0	2	0	0	3	2
/datadrive/data/ESAdocs/federal_register/citation.result.FR.action?federalRegister.volume=2008andfederalRegister.page=14995andpublication=FR.pdf	0	0	0	0	2	0	0	2	3
/datadrive/data/ESAdocs/federal_register/citation.result.FR.action?federalRegister.volume=2008andfederalRegister.page=1525andpublication=FR.pdf	1	0	0	4	19	0	0	24	30
/datadrive/data/ESAdocs/federal_register/citation.result.FR.action?federalRegister.volume=2008andfederalRegister.page=16319andpublication=FR.pdf	0	0	0	0	3	0	0	3	3
/datadrive/data/ESAdocs/federal_register/citation.result.FR.action?federalRegister.volume=2008andfederalRegister.page=17762andpublication=FR.pdf	15	0	2	1	22	0	1	41	47
/datadrive/data/ESAdocs/federal_register/citation.result.FR.action?federalRegister.volume=2008andfederalRegister.page=1893andpublication=FR.pdf	0	0	0	0	2	0	0	2	2
/datadrive/data/ESAdocs/federal_register/citation.result.FR.action?federalRegister.volume=2008andfederalRegister.page=19000andpublication=FR.pdf	0	0	0	0	10	0	1	11	15
/datadrive/data/ESAdocs/federal_register/citation.result.FR.action?federalRegister.volume=2008andfederalRegister.page=19525andpublication=FR.pdf	0	0	0	0	2	0	0	2	2
/datadrive/data/ESAdocs/federal_register/citation.result.FR.action?federalRegister.volume=2008andfederalRegister.page=20237andpublication=FR.pdf	0	0	0	0	4	0	0	4	5
/datadrive/data/ESAdocs/federal_register/citation.result.FR.action?federalRegister.volume=2008andfederalRegister.page=20581andpublication=FR.pdf	0	0	0	0	11	3	0	14	19
/datadrive/data/ESAdocs/federal_register/citation.result.FR.action?federalRegister.volume=2008andfederalRegister.page=20600andpublication=FR.pdf	0	0	0	0	7	0	0	7	8
/datadrive/data/ESAdocs/federal_register/citation.result.FR.action?federalRegister.volume=2008andfederalRegister.page=20702andpublication=FR.pdf	0	0	0	0	2	0	0	2	3
/datadrive/data/ESAdocs/federal_register/citation.result.FR.action?federalRegister.volume=2008andfederalRegister.page=21643andpublication=FR.pdf	0	0	0	0	3	0	1	4	3
/datadrive/data/ESAdocs/federal_register/citation.result.FR.action?federalRegister.volume=2008andfederalRegister.page=21913andpublication=FR.pdf	0	0	0	0	5	2	1	8	5
/datadrive/data/ESAdocs/federal_register/citation.result.FR.action?federalRegister.volume=2008andfederalRegister.page=23264andpublication=FR.pdf	0	0	0	0	3	0	0	3	3
/datadrive/data/ESAdocs/federal_register/citation.result.FR.action?federalRegister.volume=2008andfederalRegister.page=24612andpublication=FR.pdf	0	0	0	0	2	0	1	3	2
/datadrive/data/ESAdocs/federal_register/citation.result.FR.action?federalRegister.volume=2008andfederalRegister.page=24915andpublication=FR.pdf	0	0	0	0	6	2	2	10	8
/datadrive/data/ESAdocs/federal_register/citation.result.FR.action?federalRegister.volume=2008andfederalRegister.page=28094andpublication=FR.pdf	0	0	1	1	3	0	0	5	4
/datadrive/data/ESAdocs/federal_register/citation.result.FR.action?federalRegister.volume=2008andfederalRegister.page=28212andpublication=FR.pdf	0	0	1	0	61	0	0	62	93
/datadrive/data/ESAdocs/federal_register/citation.result.FR.action?federalRegister.volume=2008andfederalRegister.page=28306andpublication=FR.pdf	0	0	1	0	12	0	0	13	14
/datadrive/data/ESAdocs/federal_register/citation.result.FR.action?federalRegister.volume=2008andfederalRegister.page=28494andpublication=FR.pdf	0	0	0	0	2	0	0	2	2
/datadrive/data/ESAdocs/federal_register/citation.result.FR.action?federalRegister.volume=2008andfederalRegister.page=29294andpublication=FR.pdf	0	0	0	0	16	3	1	20	29
/datadrive/data/ESAdocs/federal_register/citation.result.FR.action?federalRegister.volume=2008andfederalRegister.page=30361andpublication=FR.pdf	1	0	0	0	12	3	4	20	14
/datadrive/data/ESAdocs/federal_register/citation.result.FR.action?federalRegister.volume=2008andfederalRegister.page=30596andpublication=FR.pdf	0	0	0	0	0	0	0	0	3
/datadrive/data/ESAdocs/federal_register/citation.result.FR.action?federalRegister.volume=2008andfederalRegister.page=31066andpublication=FR.pdf	0	0	0	0	0	0	0	0	2
/datadrive/data/ESAdocs/federal_register/citation.result.FR.action?federalRegister.volume=2008andfederalRegister.page=3146andpublication=FR.pdf	1	4	1	0	30	1	0	37	35
/datadrive/data/ESAdocs/federal_register/citation.result.FR.action?federalRegister.volume=2008andfederalRegister.page=32629andpublication=FR.pdf	0	0	0	0	1	0	0	1	1
/datadrive/data/ESAdocs/federal_register/citation.result.FR.action?federalRegister.volume=2008andfederalRegister.page=3328andpublication=FR.pdf	0	0	0	0	26	0	0	26	47
/datadrive/data/ESAdocs/federal_register/citation.result.FR.action?federalRegister.volume=2008andfederalRegister.page=33968andpublication=FR.pdf	0	0	0	0	2	0	0	2	3
/datadrive/data/ESAdocs/federal_register/citation.result.FR.action?federalRegister.volume=2008andfederalRegister.page=34313andpublication=FR.pdf	0	0	0	0	2	0	0	2	2
/datadrive/data/ESAdocs/federal_register/citation.result.FR.action?federalRegister.volume=2008andfederalRegister.page=39025andpublication=FR.pdf	0	0	1	0	0	0	0	1	2
/datadrive/data/ESAdocs/federal_register/citation.result.FR.action?federalRegister.volume=2008andfederalRegister.page=39506andpublication=FR.pdf	0	0	0	0	16	5	1	22	19
/datadrive/data/ESAdocs/federal_register/citation.result.FR.action?federalRegister.volume=2008andfederalRegister.page=39639andpublication=FR.pdf	0	0	0	0	5	0	0	5	5
/datadrive/data/ESAdocs/federal_register/citation.result.FR.action?federalRegister.volume=2008andfederalRegister.page=39790andpublication=FR.pdf	5	0	2	1	39	2	4	53	50
/datadrive/data/ESAdocs/federal_register/citation.result.FR.action?federalRegister.volume=2008andfederalRegister.page=3991andpublication=FR.pdf	0	0	0	0	2	0	0	2	3
/datadrive/data/ESAdocs/federal_register/citation.result.FR.action?federalRegister.volume=2008andfederalRegister.page=41007andpublication=FR.pdf	0	0	0	0	11	0	0	11	16
/datadrive/data/ESAdocs/federal_register/citation.result.FR.action?federalRegister.volume=2008andfederalRegister.page=44678andpublication=FR.pdf	0	0	0	0	8	0	0	8	24
/datadrive/data/ESAdocs/federal_register/citation.result.FR.action?federalRegister.volume=2008andfederalRegister.page=45236andpublication=FR.pdf	1	0	0	0	3	0	0	4	3
/datadrive/data/ESAdocs/federal_register/citation.result.FR.action?federalRegister.volume=2008andfederalRegister.page=45534andpublication=FR.pdf	10	53	6	1	39	0	0	109	72
/datadrive/data/ESAdocs/federal_register/citation.result.FR.action?federalRegister.volume=2008andfederalRegister.page=45680andpublication=FR.pdf	1	0	0	0	10	0	0	11	10
/datadrive/data/ESAdocs/federal_register/citation.result.FR.action?federalRegister.volume=2008andfederalRegister.page=45806andpublication=FR.pdf	1	0	4	2	22	0	0	29	42
/datadrive/data/ESAdocs/federal_register/citation.result.FR.action?federalRegister.volume=2008andfederalRegister.page=46867andpublication=FR.pdf	0	0	0	0	1	0	0	1	2
/datadrive/data/ESAdocs/federal_register/citation.result.FR.action?federalRegister.volume=2008andfederalRegister.page=46988andpublication=FR.pdf	5	2	1	0	24	11	10	53	40
/datadrive/data/ESAdocs/federal_register/citation.result.FR.action?federalRegister.volume=2008andfederalRegister.page=4720andpublication=FR.pdf	7	3	1	1	14	0	0	26	17
/datadrive/data/ESAdocs/federal_register/citation.result.FR.action?federalRegister.volume=2008andfederalRegister.page=47258andpublication=FR.pdf	0	0	0	0	39	2	2	43	68
/datadrive/data/ESAdocs/federal_register/citation.result.FR.action?federalRegister.volume=2008andfederalRegister.page=47326andpublication=FR.pdf	0	0	0	0	38	0	2	40	198
/datadrive/data/ESAdocs/federal_register/citation.result.FR.action?federalRegister.volume=2008andfederalRegister.page=47706andpublication=FR.pdf	3	0	5	1	36	0	0	45	63
/datadrive/data/ESAdocs/federal_register/citation.result.FR.action?federalRegister.volume=2008andfederalRegister.page=49647andpublication=FR.pdf	0	0	0	0	2	0	0	2	2
/datadrive/data/ESAdocs/federal_register/citation.result.FR.action?federalRegister.volume=2008andfederalRegister.page=50406andpublication=FR.pdf	2	0	1	1	32	0	0	36	48
/datadrive/data/ESAdocs/federal_register/citation.result.FR.action?federalRegister.volume=2008andfederalRegister.page=50454andpublication=FR.pdf	3	0	0	3	28	0	0	34	44
/datadrive/data/ESAdocs/federal_register/citation.result.FR.action?federalRegister.volume=2008andfederalRegister.page=50498andpublication=FR.pdf	0	13	1	0	6	0	0	20	33
/datadrive/data/ESAdocs/federal_register/citation.result.FR.action?federalRegister.volume=2008andfederalRegister.page=51415andpublication=FR.pdf	1	3	0	0	19	1	7	31	22
/datadrive/data/ESAdocs/federal_register/citation.result.FR.action?federalRegister.volume=2008andfederalRegister.page=52257andpublication=FR.pdf	0	0	0	0	3	0	0	3	4
/datadrive/data/ESAdocs/federal_register/citation.result.FR.action?federalRegister.volume=2008andfederalRegister.page=53492andpublication=FR.pdf	2	0	1	1	50	3	4	61	190
/datadrive/data/ESAdocs/federal_register/citation.result.FR.action?federalRegister.volume=2008andfederalRegister.page=54345andpublication=FR.pdf	0	0	0	0	2	0	0	2	2
/datadrive/data/ESAdocs/federal_register/citation.result.FR.action?federalRegister.volume=2008andfederalRegister.page=54603andpublication=FR.pdf	0	0	0	0	2	0	0	2	2
/datadrive/data/ESAdocs/federal_register/citation.result.FR.action?federalRegister.volume=2008andfederalRegister.page=56860andpublication=FR.pdf	0	0	0	0	3	0	0	3	3
/datadrive/data/ESAdocs/federal_register/citation.result.FR.action?federalRegister.volume=2008andfederalRegister.page=57314andpublication=FR.pdf	0	0	0	0	3	0	0	3	4
/datadrive/data/ESAdocs/federal_register/citation.result.FR.action?federalRegister.volume=2008andfederalRegister.page=58261andpublication=FR.pdf	0	0	0	0	2	0	0	2	2
/datadrive/data/ESAdocs/federal_register/citation.result.FR.action?federalRegister.volume=2008andfederalRegister.page=58263andpublication=FR.pdf	0	0	0	0	1	0	0	1	2
/datadrive/data/ESAdocs/federal_register/citation.result.FR.action?federalRegister.volume=2008andfederalRegister.page=58975andpublication=FR.pdf	0	0	0	0	1	0	0	1	2
/datadrive/data/ESAdocs/federal_register/citation.result.FR.action?federalRegister.volume=2008andfederalRegister.page=5920andpublication=FR.pdf	1	0	4	0	29	6	3	43	88
/datadrive/data/ESAdocs/federal_register/citation.result.FR.action?federalRegister.volume=2008andfederalRegister.page=61936andpublication=FR.pdf	1	0	1	0	43	7	0	52	68
/datadrive/data/ESAdocs/federal_register/citation.result.FR.action?federalRegister.volume=2008andfederalRegister.page=62592andpublication=FR.pdf	2	0	5	7	79	1	1	95	152
/datadrive/data/ESAdocs/federal_register/citation.result.FR.action?federalRegister.volume=2008andfederalRegister.page=62816andpublication=FR.pdf	0	0	0	0	18	5	2	25	27
/datadrive/data/ESAdocs/federal_register/citation.result.FR.action?federalRegister.volume=2008andfederalRegister.page=63926andpublication=FR.pdf	1	1	1	0	6	0	0	9	7
/datadrive/data/ESAdocs/federal_register/citation.result.FR.action?federalRegister.volume=2008andfederalRegister.page=66003andpublication=FR.pdf	4	0	2	4	4	0	0	14	7
/datadrive/data/ESAdocs/federal_register/citation.result.FR.action?federalRegister.volume=2008andfederalRegister.page=67541andpublication=FR.pdf	0	0	0	0	2	0	0	2	2
/datadrive/data/ESAdocs/federal_register/citation.result.FR.action?federalRegister.volume=2008andfederalRegister.page=71788andpublication=FR.pdf	9	2	3	3	33	4	2	56	40
/datadrive/data/ESAdocs/federal_register/citation.result.FR.action?federalRegister.volume=2008andfederalRegister.page=72210andpublication=FR.pdf	0	0	0	0	24	21	11	56	32
/datadrive/data/ESAdocs/federal_register/citation.result.FR.action?federalRegister.volume=2008andfederalRegister.page=73795andpublication=FR.pdf	0	0	1	1	22	0	0	24	102
/datadrive/data/ESAdocs/federal_register/citation.result.FR.action?federalRegister.volume=2008andfederalRegister.page=74357andpublication=FR.pdf	1	0	0	0	16	0	5	22	16
/datadrive/data/ESAdocs/federal_register/citation.result.FR.action?federalRegister.volume=2008andfederalRegister.page=74427andpublication=FR.pdf	0	0	0	0	6	0	0	6	8
/datadrive/data/ESAdocs/federal_register/citation.result.FR.action?federalRegister.volume=2008andfederalRegister.page=74434andpublication=FR.pdf	2	0	4	3	11	0	0	20	12
/datadrive/data/ESAdocs/federal_register/citation.result.FR.action?federalRegister.volume=2008andfederalRegister.page=74674andpublication=FR.pdf	0	0	0	0	1	0	0	1	2
/datadrive/data/ESAdocs/federal_register/citation.result.FR.action?federalRegister.volume=2008andfederalRegister.page=75176andpublication=FR.pdf	10	2	15	0	59	0	0	86	70
/datadrive/data/ESAdocs/federal_register/citation.result.FR.action?federalRegister.volume=2008andfederalRegister.page=75356andpublication=FR.pdf	4	3	2	0	14	0	0	23	16
/datadrive/data/ESAdocs/federal_register/citation.result.FR.action?federalRegister.volume=2008andfederalRegister.page=76249andpublication=FR.pdf	0	0	2	0	21	0	0	23	21
/datadrive/data/ESAdocs/federal_register/citation.result.FR.action?federalRegister.volume=2008andfederalRegister.page=76373andpublication=FR.pdf	0	0	0	0	3	0	0	3	3
/datadrive/data/ESAdocs/federal_register/citation.result.FR.action?federalRegister.volume=2008andfederalRegister.page=76454andpublication=FR.pdf	0	0	0	0	13	1	0	14	17
/datadrive/data/ESAdocs/federal_register/citation.result.FR.action?federalRegister.volume=2008andfederalRegister.page=76680andpublication=FR.pdf	0	0	0	0	3	0	0	3	3
/datadrive/data/ESAdocs/federal_register/citation.result.FR.action?federalRegister.volume=2008andfederalRegister.page=76990andpublication=FR.pdf	0	0	0	0	3	0	0	3	5
/datadrive/data/ESAdocs/federal_register/citation.result.FR.action?federalRegister.volume=2008andfederalRegister.page=77052andpublication=FR.pdf	1	0	0	0	2	0	0	3	2
/datadrive/data/ESAdocs/federal_register/citation.result.FR.action?federalRegister.volume=2008andfederalRegister.page=77264andpublication=FR.pdf	1	0	0	0	23	0	0	24	40
/datadrive/data/ESAdocs/federal_register/citation.result.FR.action?federalRegister.volume=2008andfederalRegister.page=77303andpublication=FR.pdf	2	4	5	4	22	0	0	37	30
/datadrive/data/ESAdocs/federal_register/citation.result.FR.action?federalRegister.volume=2008andfederalRegister.page=77332andpublication=FR.pdf	0	0	0	0	6	1	0	7	10
/datadrive/data/ESAdocs/federal_register/citation.result.FR.action?federalRegister.volume=2008andfederalRegister.page=78822andpublication=FR.pdf	1	0	0	0	2	0	0	3	2
/datadrive/data/ESAdocs/federal_register/citation.result.FR.action?federalRegister.volume=2008andfederalRegister.page=79226andpublication=FR.pdf	3	2	3	0	21	2	1	32	29
/datadrive/data/ESAdocs/federal_register/citation.result.FR.action?federalRegister.volume=2008andfederalRegister.page=8345andpublication=FR.pdf	0	2	0	0	2	0	0	4	2
/datadrive/data/ESAdocs/federal_register/citation.result.FR.action?federalRegister.volume=2008andfederalRegister.page=8412andpublication=FR.pdf	2	0	0	1	23	3	0	29	30
/datadrive/data/ESAdocs/federal_register/citation.result.FR.action?federalRegister.volume=2008andfederalRegister.page=8748andpublication=FR.pdf	0	0	0	0	21	0	0	21	39
/datadrive/data/ESAdocs/federal_register/citation.result.FR.action?federalRegister.volume=2008andfederalRegister.page=9078andpublication=FR.pdf	0	0	1	1	7	0	0	9	8
/datadrive/data/ESAdocs/federal_register/citation.result.FR.action?federalRegister.volume=2008andfederalRegister.page=9755andpublication=FR.pdf	0	0	0	0	1	0	0	1	2
/datadrive/data/ESAdocs/federal_register/citation.result.FR.action?federalRegister.volume=2009andfederalRegister.page=10211andpublication=FR.pdf	1	0	0	0	7	0	0	8	7
/datadrive/data/ESAdocs/federal_register/citation.result.FR.action?federalRegister.volume=2009andfederalRegister.page=10701andpublication=FR.pdf	0	0	0	0	1	0	0	1	3
/datadrive/data/ESAdocs/federal_register/citation.result.FR.action?federalRegister.volume=2009andfederalRegister.page=11130andpublication=FR.pdf	0	0	0	0	4	0	0	4	4
/datadrive/data/ESAdocs/federal_register/citation.result.FR.action?federalRegister.volume=2009andfederalRegister.page=11319andpublication=FR.pdf	0	0	1	2	7	0	0	10	9
/datadrive/data/ESAdocs/federal_register/citation.result.FR.action?federalRegister.volume=2009andfederalRegister.page=11600andpublication=FR.pdf	0	0	0	0	1	0	0	1	3
/datadrive/data/ESAdocs/federal_register/citation.result.FR.action?federalRegister.volume=2009andfederalRegister.page=12878andpublication=FR.pdf	0	3	0	0	5	0	0	8	6
/datadrive/data/ESAdocs/federal_register/citation.result.FR.action?federalRegister.volume=2009andfederalRegister.page=15070andpublication=FR.pdf	18	1	1	0	53	0	0	73	55
/datadrive/data/ESAdocs/federal_register/citation.result.FR.action?federalRegister.volume=2009andfederalRegister.page=15123andpublication=FR.pdf	32	5	6	0	64	0	0	107	66
/datadrive/data/ESAdocs/federal_register/citation.result.FR.action?federalRegister.volume=2009andfederalRegister.page=16169andpublication=FR.pdf	0	0	0	0	6	0	0	6	7
/datadrive/data/ESAdocs/federal_register/citation.result.FR.action?federalRegister.volume=2009andfederalRegister.page=16230andpublication=FR.pdf	0	0	0	0	3	0	1	4	3
/datadrive/data/ESAdocs/federal_register/citation.result.FR.action?federalRegister.volume=2009andfederalRegister.page=16232andpublication=FR.pdf	0	0	0	0	2	0	1	3	2
/datadrive/data/ESAdocs/federal_register/citation.result.FR.action?federalRegister.volume=2009andfederalRegister.page=17288andpublication=FR.pdf	3	58	1	0	48	0	1	111	79
/datadrive/data/ESAdocs/federal_register/citation.result.FR.action?federalRegister.volume=2009andfederalRegister.page=17877andpublication=FR.pdf	0	0	0	0	2	0	0	2	2
/datadrive/data/ESAdocs/federal_register/citation.result.FR.action?federalRegister.volume=2009andfederalRegister.page=18341andpublication=FR.pdf	1	0	0	0	4	0	0	5	7
/datadrive/data/ESAdocs/federal_register/citation.result.FR.action?federalRegister.volume=2009andfederalRegister.page=18403andpublication=FR.pdf	0	0	0	0	1	0	1	2	2
/datadrive/data/ESAdocs/federal_register/citation.result.FR.action?federalRegister.volume=2009andfederalRegister.page=19167andpublication=FR.pdf	0	0	0	0	3	0	0	3	18
/datadrive/data/ESAdocs/federal_register/citation.result.FR.action?federalRegister.volume=2009andfederalRegister.page=19184andpublication=FR.pdf	0	0	0	0	7	0	0	7	9
/datadrive/data/ESAdocs/federal_register/citation.result.FR.action?federalRegister.volume=2009andfederalRegister.page=1937andpublication=FR.pdf	0	0	0	0	9	1	1	11	10
/datadrive/data/ESAdocs/federal_register/citation.result.FR.action?federalRegister.volume=2009andfederalRegister.page=21614andpublication=FR.pdf	0	0	0	0	1	0	0	1	2
/datadrive/data/ESAdocs/federal_register/citation.result.FR.action?federalRegister.volume=2009andfederalRegister.page=23476andpublication=FR.pdf	0	0	0	0	24	2	2	28	126
/datadrive/data/ESAdocs/federal_register/citation.result.FR.action?federalRegister.volume=2009andfederalRegister.page=23739andpublication=FR.pdf	0	0	0	0	3	1	0	4	3
/datadrive/data/ESAdocs/federal_register/citation.result.FR.action?federalRegister.volume=2009andfederalRegister.page=26488andpublication=FR.pdf	1	0	0	0	18	3	9	31	24
/datadrive/data/ESAdocs/federal_register/citation.result.FR.action?federalRegister.volume=2009andfederalRegister.page=27004andpublication=FR.pdf	0	0	0	0	0	0	0	0	2
/datadrive/data/ESAdocs/federal_register/citation.result.FR.action?federalRegister.volume=2009andfederalRegister.page=27271andpublication=FR.pdf	0	0	0	0	1	0	2	3	5
/datadrive/data/ESAdocs/federal_register/citation.result.FR.action?federalRegister.volume=2009andfederalRegister.page=27588andpublication=FR.pdf	0	3	3	3	28	1	0	38	54
/datadrive/data/ESAdocs/federal_register/citation.result.FR.action?federalRegister.volume=2009andfederalRegister.page=28723andpublication=FR.pdf	0	0	0	0	1	0	1	2	2
/datadrive/data/ESAdocs/federal_register/citation.result.FR.action?federalRegister.volume=2009andfederalRegister.page=28776andpublication=FR.pdf	0	0	0	1	49	0	0	50	88
/datadrive/data/ESAdocs/federal_register/citation.result.FR.action?federalRegister.volume=2009andfederalRegister.page=29300andpublication=FR.pdf	0	4	1	0	36	4	7	52	43
/datadrive/data/ESAdocs/federal_register/citation.result.FR.action?federalRegister.volume=2009andfederalRegister.page=29344andpublication=FR.pdf	1	4	0	0	41	4	10	60	45
/datadrive/data/ESAdocs/federal_register/citation.result.FR.action?federalRegister.volume=2009andfederalRegister.page=29456andpublication=FR.pdf	0	0	0	0	5	0	0	5	6
/datadrive/data/ESAdocs/federal_register/citation.result.FR.action?federalRegister.volume=2009andfederalRegister.page=2995andpublication=FR.pdf	0	0	0	0	2	0	0	2	2
/datadrive/data/ESAdocs/federal_register/citation.result.FR.action?federalRegister.volume=2009andfederalRegister.page=30617andpublication=FR.pdf	0	0	0	0	3	0	1	4	3
/datadrive/data/ESAdocs/federal_register/citation.result.FR.action?federalRegister.volume=2009andfederalRegister.page=30996andpublication=FR.pdf	0	0	0	0	2	0	1	3	4
/datadrive/data/ESAdocs/federal_register/citation.result.FR.action?federalRegister.volume=2009andfederalRegister.page=31114andpublication=FR.pdf	4	0	0	0	26	13	17	60	39
/datadrive/data/ESAdocs/federal_register/citation.result.FR.action?federalRegister.volume=2009andfederalRegister.page=31972andpublication=FR.pdf	0	0	0	0	2	0	0	2	2
/datadrive/data/ESAdocs/federal_register/citation.result.FR.action?federalRegister.volume=2009andfederalRegister.page=32308andpublication=FR.pdf	1	0	10	0	39	0	0	50	43
/datadrive/data/ESAdocs/federal_register/citation.result.FR.action?federalRegister.volume=2009andfederalRegister.page=32352andpublication=FR.pdf	12	1	2	3	31	11	7	67	37
/datadrive/data/ESAdocs/federal_register/citation.result.FR.action?federalRegister.volume=2009andfederalRegister.page=32490andpublication=FR.pdf	0	0	0	2	20	4	0	26	21
/datadrive/data/ESAdocs/federal_register/citation.result.FR.action?federalRegister.volume=2009andfederalRegister.page=32510andpublication=FR.pdf	0	0	0	0	3	0	1	4	4
/datadrive/data/ESAdocs/federal_register/citation.result.FR.action?federalRegister.volume=2009andfederalRegister.page=32857andpublication=FR.pdf	0	0	0	0	18	1	0	19	19
/datadrive/data/ESAdocs/federal_register/citation.result.FR.action?federalRegister.volume=2009andfederalRegister.page=33957andpublication=FR.pdf	0	0	1	0	3	0	0	4	4
/datadrive/data/ESAdocs/federal_register/citation.result.FR.action?federalRegister.volume=2009andfederalRegister.page=35883andpublication=FR.pdf	0	0	0	0	3	0	1	4	3
/datadrive/data/ESAdocs/federal_register/citation.result.FR.action?federalRegister.volume=2009andfederalRegister.page=37314andpublication=FR.pdf	2	0	3	0	36	1	1	43	80
/datadrive/data/ESAdocs/federal_register/citation.result.FR.action?federalRegister.volume=2009andfederalRegister.page=40132andpublication=FR.pdf	0	0	0	0	6	0	0	6	7
/datadrive/data/ESAdocs/federal_register/citation.result.FR.action?federalRegister.volume=2009andfederalRegister.page=40540andpublication=FR.pdf	2	1	3	1	17	0	0	24	21
/datadrive/data/ESAdocs/federal_register/citation.result.FR.action?federalRegister.volume=2009andfederalRegister.page=40650andpublication=FR.pdf	12	0	0	0	33	0	0	45	35
/datadrive/data/ESAdocs/federal_register/citation.result.FR.action?federalRegister.volume=2009andfederalRegister.page=41649andpublication=FR.pdf	8	0	1	7	13	0	1	30	14
/datadrive/data/ESAdocs/federal_register/citation.result.FR.action?federalRegister.volume=2009andfederalRegister.page=41662andpublication=FR.pdf	1	0	0	1	9	0	1	12	12
/datadrive/data/ESAdocs/federal_register/citation.result.FR.action?federalRegister.volume=2009andfederalRegister.page=419andpublication=FR.pdf	0	0	0	1	7	1	0	9	9
/datadrive/data/ESAdocs/federal_register/citation.result.FR.action?federalRegister.volume=2009andfederalRegister.page=44238andpublication=FR.pdf	0	1	0	1	22	0	0	24	31
/datadrive/data/ESAdocs/federal_register/citation.result.FR.action?federalRegister.volume=2009andfederalRegister.page=45649andpublication=FR.pdf	1	0	0	0	2	1	0	4	2
/datadrive/data/ESAdocs/federal_register/citation.result.FR.action?federalRegister.volume=2009andfederalRegister.page=46401andpublication=FR.pdf	0	0	0	0	6	0	0	6	6
/datadrive/data/ESAdocs/federal_register/citation.result.FR.action?federalRegister.volume=2009andfederalRegister.page=46542andpublication=FR.pdf	2	1	1	0	4	0	1	9	6
/datadrive/data/ESAdocs/federal_register/citation.result.FR.action?federalRegister.volume=2009andfederalRegister.page=46548andpublication=FR.pdf	0	0	0	0	3	0	0	3	4
/datadrive/data/ESAdocs/federal_register/citation.result.FR.action?federalRegister.volume=2009andfederalRegister.page=46914andpublication=FR.pdf	4	0	0	0	16	0	0	20	17
/datadrive/data/ESAdocs/federal_register/citation.result.FR.action?federalRegister.volume=2009andfederalRegister.page=46965andpublication=FR.pdf	0	0	0	0	1	0	0	1	2
/datadrive/data/ESAdocs/federal_register/citation.result.FR.action?federalRegister.volume=2009andfederalRegister.page=47112andpublication=FR.pdf	0	0	0	0	4	0	0	4	6
/datadrive/data/ESAdocs/federal_register/citation.result.FR.action?federalRegister.volume=2009andfederalRegister.page=47483andpublication=FR.pdf	0	0	0	0	6	0	0	6	6
/datadrive/data/ESAdocs/federal_register/citation.result.FR.action?federalRegister.volume=2009andfederalRegister.page=47536andpublication=FR.pdf	1	0	0	0	9	4	7	21	10
/datadrive/data/ESAdocs/federal_register/citation.result.FR.action?federalRegister.volume=2009andfederalRegister.page=48215andpublication=FR.pdf	0	0	0	0	5	0	0	5	6
/datadrive/data/ESAdocs/federal_register/citation.result.FR.action?federalRegister.volume=2009andfederalRegister.page=48284andpublication=FR.pdf	0	0	0	0	2	0	0	2	2
/datadrive/data/ESAdocs/federal_register/citation.result.FR.action?federalRegister.volume=2009andfederalRegister.page=4912andpublication=FR.pdf	0	0	0	0	0	0	0	0	1
/datadrive/data/ESAdocs/federal_register/citation.result.FR.action?federalRegister.volume=2009andfederalRegister.page=49835andpublication=FR.pdf	1	0	0	0	6	1	0	8	8
/datadrive/data/ESAdocs/federal_register/citation.result.FR.action?federalRegister.volume=2009andfederalRegister.page=49842andpublication=FR.pdf	0	0	0	0	3	0	3	6	4
/datadrive/data/ESAdocs/federal_register/citation.result.FR.action?federalRegister.volume=2009andfederalRegister.page=51825andpublication=FR.pdf	0	0	0	0	5	0	0	5	5
/datadrive/data/ESAdocs/federal_register/citation.result.FR.action?federalRegister.volume=2009andfederalRegister.page=51988andpublication=FR.pdf	0	0	0	0	18	1	4	23	26
/datadrive/data/ESAdocs/federal_register/citation.result.FR.action?federalRegister.volume=2009andfederalRegister.page=52014andpublication=FR.pdf	18	3	2	9	50	3	0	85	52
/datadrive/data/ESAdocs/federal_register/citation.result.FR.action?federalRegister.volume=2009andfederalRegister.page=52066andpublication=FR.pdf	0	1	1	0	20	3	0	25	43
/datadrive/data/ESAdocs/federal_register/citation.result.FR.action?federalRegister.volume=2009andfederalRegister.page=52612andpublication=FR.pdf	5	0	2	2	39	9	6	63	54
/datadrive/data/ESAdocs/federal_register/citation.result.FR.action?federalRegister.volume=2009andfederalRegister.page=53999andpublication=FR.pdf	0	0	0	0	9	0	0	9	19
/datadrive/data/ESAdocs/federal_register/citation.result.FR.action?federalRegister.volume=2009andfederalRegister.page=56058andpublication=FR.pdf	0	0	0	0	22	0	0	22	30
/datadrive/data/ESAdocs/federal_register/citation.result.FR.action?federalRegister.volume=2009andfederalRegister.page=56757andpublication=FR.pdf	0	0	0	0	13	0	0	13	14
/datadrive/data/ESAdocs/federal_register/citation.result.FR.action?federalRegister.volume=2009andfederalRegister.page=56770andpublication=FR.pdf	0	0	0	0	20	0	0	20	22
/datadrive/data/ESAdocs/federal_register/citation.result.FR.action?federalRegister.volume=2009andfederalRegister.page=56978andpublication=FR.pdf	1	0	3	2	37	0	1	44	70
/datadrive/data/ESAdocs/federal_register/citation.result.FR.action?federalRegister.volume=2009andfederalRegister.page=57804andpublication=FR.pdf	12	5	13	12	62	10	4	118	76
/datadrive/data/ESAdocs/federal_register/citation.result.FR.action?federalRegister.volume=2009andfederalRegister.page=57987andpublication=FR.pdf	0	0	0	0	2	0	0	2	2
/datadrive/data/ESAdocs/federal_register/citation.result.FR.action?federalRegister.volume=2009andfederalRegister.page=5908andpublication=FR.pdf	0	0	0	0	2	0	0	2	3
/datadrive/data/ESAdocs/federal_register/citation.result.FR.action?federalRegister.volume=2009andfederalRegister.page=59956andpublication=FR.pdf	0	0	0	0	1	0	0	1	2
/datadrive/data/ESAdocs/federal_register/citation.result.FR.action?federalRegister.volume=2009andfederalRegister.page=61100andpublication=FR.pdf	1	1	0	0	2	0	0	4	3
/datadrive/data/ESAdocs/federal_register/citation.result.FR.action?federalRegister.volume=2009andfederalRegister.page=6122andpublication=FR.pdf	0	0	0	0	5	0	0	5	7
/datadrive/data/ESAdocs/federal_register/citation.result.FR.action?federalRegister.volume=2009andfederalRegister.page=63366andpublication=FR.pdf	1	0	0	0	17	8	9	35	19
/datadrive/data/ESAdocs/federal_register/citation.result.FR.action?federalRegister.volume=2009andfederalRegister.page=64930andpublication=FR.pdf	0	2	3	4	30	0	0	39	54
/datadrive/data/ESAdocs/federal_register/citation.result.FR.action?federalRegister.volume=2009andfederalRegister.page=65045andpublication=FR.pdf	1	0	0	0	10	1	2	14	12
/datadrive/data/ESAdocs/federal_register/citation.result.FR.action?federalRegister.volume=2009andfederalRegister.page=65056andpublication=FR.pdf	1	0	4	0	26	15	6	52	32
/datadrive/data/ESAdocs/federal_register/citation.result.FR.action?federalRegister.volume=2009andfederalRegister.page=66260andpublication=FR.pdf	0	0	0	0	7	2	0	9	12
/datadrive/data/ESAdocs/federal_register/citation.result.FR.action?federalRegister.volume=2009andfederalRegister.page=66866andpublication=FR.pdf	15	2	2	10	36	2	7	74	41
/datadrive/data/ESAdocs/federal_register/citation.result.FR.action?federalRegister.volume=2009andfederalRegister.page=66937andpublication=FR.pdf	0	1	0	0	8	0	0	9	14
/datadrive/data/ESAdocs/federal_register/citation.result.FR.action?federalRegister.volume=2009andfederalRegister.page=6700andpublication=FR.pdf	0	0	0	0	50	2	2	54	76
/datadrive/data/ESAdocs/federal_register/citation.result.FR.action?federalRegister.volume=2009andfederalRegister.page=6852andpublication=FR.pdf	0	0	0	0	0	0	0	0	2
/datadrive/data/ESAdocs/federal_register/citation.result.FR.action?federalRegister.volume=2009andfederalRegister.page=6853andpublication=FR.pdf	0	0	0	0	0	0	0	0	2
/datadrive/data/ESAdocs/federal_register/citation.result.FR.action?federalRegister.volume=2009andfederalRegister.page=6917andpublication=FR.pdf	0	0	0	0	3	0	0	3	3
/datadrive/data/ESAdocs/federal_register/citation.result.FR.action?federalRegister.volume=2009andfederalRegister.page=7914andpublication=FR.pdf	0	0	0	0	2	0	0	2	2
/datadrive/data/ESAdocs/federal_register/citation.result.FR.action?federalRegister.volume=2009andfederalRegister.page=8616andpublication=FR.pdf	2	0	1	0	38	0	0	41	88
/datadrive/data/ESAdocs/federal_register/citation.result.FR.action?federalRegister.volume=2009andfederalRegister.page=913andpublication=FR.pdf	0	0	0	0	3	0	0	3	3
/datadrive/data/ESAdocs/federal_register/citation.result.FR.action?federalRegister.volume=2010andfederalRegister.page=11080andpublication=FR.pdf	0	0	0	0	11	2	0	13	24
/datadrive/data/ESAdocs/federal_register/citation.result.FR.action?federalRegister.volume=2010andfederalRegister.page=12496andpublication=FR.pdf	0	0	0	0	0	0	0	0	2
/datadrive/data/ESAdocs/federal_register/citation.result.FR.action?federalRegister.volume=2010andfederalRegister.page=12598andpublication=FR.pdf	0	1	0	3	44	4	1	53	60
/datadrive/data/ESAdocs/federal_register/citation.result.FR.action?federalRegister.volume=2010andfederalRegister.page=12816andpublication=FR.pdf	7	0	3	1	68	6	8	93	145
/datadrive/data/ESAdocs/federal_register/citation.result.FR.action?federalRegister.volume=2010andfederalRegister.page=13068andpublication=FR.pdf	0	0	0	0	4	0	0	4	4
/datadrive/data/ESAdocs/federal_register/citation.result.FR.action?federalRegister.volume=2010andfederalRegister.page=13720andpublication=FR.pdf	0	0	0	0	5	0	1	6	7
/datadrive/data/ESAdocs/federal_register/citation.result.FR.action?federalRegister.volume=2010andfederalRegister.page=14496andpublication=FR.pdf	0	0	0	0	3	0	0	3	3
/datadrive/data/ESAdocs/federal_register/citation.result.FR.action?federalRegister.volume=2010andfederalRegister.page=15454andpublication=FR.pdf	0	0	0	0	3	0	0	3	3
/datadrive/data/ESAdocs/federal_register/citation.result.FR.action?federalRegister.volume=2010andfederalRegister.page=1567andpublication=FR.pdf	0	0	0	0	2	0	0	2	2
/datadrive/data/ESAdocs/federal_register/citation.result.FR.action?federalRegister.volume=2010andfederalRegister.page=1568andpublication=FR.pdf	0	0	0	0	7	0	0	7	7
/datadrive/data/ESAdocs/federal_register/citation.result.FR.action?federalRegister.volume=2010andfederalRegister.page=15723andpublication=FR.pdf	0	0	0	0	3	0	0	3	3
/datadrive/data/ESAdocs/federal_register/citation.result.FR.action?federalRegister.volume=2010andfederalRegister.page=1574andpublication=FR.pdf	0	0	0	0	6	0	0	6	8
/datadrive/data/ESAdocs/federal_register/citation.result.FR.action?federalRegister.volume=2010andfederalRegister.page=16404andpublication=FR.pdf	1	0	0	0	16	0	1	18	18
/datadrive/data/ESAdocs/federal_register/citation.result.FR.action?federalRegister.volume=2010andfederalRegister.page=16499andpublication=FR.pdf	1	0	0	0	2	0	0	3	2
/datadrive/data/ESAdocs/federal_register/citation.result.FR.action?federalRegister.volume=2010andfederalRegister.page=17153andpublication=FR.pdf	0	0	0	0	2	0	0	2	2
/datadrive/data/ESAdocs/federal_register/citation.result.FR.action?federalRegister.volume=2010andfederalRegister.page=1741andpublication=FR.pdf	0	0	0	0	4	0	0	4	4
/datadrive/data/ESAdocs/federal_register/citation.result.FR.action?federalRegister.volume=2010andfederalRegister.page=17466andpublication=FR.pdf	4	0	0	3	15	8	0	30	45
/datadrive/data/ESAdocs/federal_register/citation.result.FR.action?federalRegister.volume=2010andfederalRegister.page=17667andpublication=FR.pdf	0	1	0	0	8	2	1	12	14
/datadrive/data/ESAdocs/federal_register/citation.result.FR.action?federalRegister.volume=2010andfederalRegister.page=17758andpublication=FR.pdf	0	0	0	0	3	1	1	5	3
/datadrive/data/ESAdocs/federal_register/citation.result.FR.action?federalRegister.volume=2010andfederalRegister.page=17760andpublication=FR.pdf	0	0	0	0	2	0	0	2	2
/datadrive/data/ESAdocs/federal_register/citation.result.FR.action?federalRegister.volume=2010andfederalRegister.page=17947andpublication=FR.pdf	0	0	0	0	4	0	0	4	4
/datadrive/data/ESAdocs/federal_register/citation.result.FR.action?federalRegister.volume=2010andfederalRegister.page=18232andpublication=FR.pdf	0	0	0	0	2	0	0	2	2
/datadrive/data/ESAdocs/federal_register/citation.result.FR.action?federalRegister.volume=2010andfederalRegister.page=18233andpublication=FR.pdf	0	0	0	0	2	0	0	2	2
/datadrive/data/ESAdocs/federal_register/citation.result.FR.action?federalRegister.volume=2010andfederalRegister.page=18960andpublication=FR.pdf	2	0	6	9	96	1	0	114	207
/datadrive/data/ESAdocs/federal_register/citation.result.FR.action?federalRegister.volume=2010andfederalRegister.page=19575andpublication=FR.pdf	0	0	0	0	8	0	0	8	16
/datadrive/data/ESAdocs/federal_register/citation.result.FR.action?federalRegister.volume=2010andfederalRegister.page=19591andpublication=FR.pdf	0	0	0	0	1	0	0	1	2
/datadrive/data/ESAdocs/federal_register/citation.result.FR.action?federalRegister.volume=2010andfederalRegister.page=2102andpublication=FR.pdf	0	0	0	0	1	0	0	1	3
/datadrive/data/ESAdocs/federal_register/citation.result.FR.action?federalRegister.volume=2010andfederalRegister.page=21394andpublication=FR.pdf	2	0	1	0	43	4	1	51	60
/datadrive/data/ESAdocs/federal_register/citation.result.FR.action?federalRegister.volume=2010andfederalRegister.page=21568andpublication=FR.pdf	0	0	0	0	3	0	0	3	4
/datadrive/data/ESAdocs/federal_register/citation.result.FR.action?federalRegister.volume=2010andfederalRegister.page=21649andpublication=FR.pdf	0	0	0	0	2	0	0	2	2
/datadrive/data/ESAdocs/federal_register/citation.result.FR.action?federalRegister.volume=2010andfederalRegister.page=2270andpublication=FR.pdf	6	3	1	0	37	5	9	61	163
/datadrive/data/ESAdocs/federal_register/citation.result.FR.action?federalRegister.volume=2010andfederalRegister.page=235andpublication=FR.pdf	1	0	1	2	16	0	0	20	16
/datadrive/data/ESAdocs/federal_register/citation.result.FR.action?federalRegister.volume=2010andfederalRegister.page=23654andpublication=FR.pdf	0	0	0	0	7	0	0	7	10
/datadrive/data/ESAdocs/federal_register/citation.result.FR.action?federalRegister.volume=2010andfederalRegister.page=24741andpublication=FR.pdf	0	0	0	0	2	0	0	2	2
/datadrive/data/ESAdocs/federal_register/citation.result.FR.action?federalRegister.volume=2010andfederalRegister.page=28636andpublication=FR.pdf	0	1	0	0	6	0	0	7	7
/datadrive/data/ESAdocs/federal_register/citation.result.FR.action?federalRegister.volume=2010andfederalRegister.page=286andpublication=FR.pdf	9	3	4	0	24	1	0	41	25
/datadrive/data/ESAdocs/federal_register/citation.result.FR.action?federalRegister.volume=2010andfederalRegister.page=30757andpublication=FR.pdf	8	0	3	6	10	2	0	29	13
/datadrive/data/ESAdocs/federal_register/citation.result.FR.action?federalRegister.volume=2010andfederalRegister.page=31387andpublication=FR.pdf	0	0	0	0	22	2	4	28	25
/datadrive/data/ESAdocs/federal_register/citation.result.FR.action?federalRegister.volume=2010andfederalRegister.page=3190andpublication=FR.pdf	0	0	0	0	2	0	0	2	2
/datadrive/data/ESAdocs/federal_register/citation.result.FR.action?federalRegister.volume=2010andfederalRegister.page=32727andpublication=FR.pdf	0	0	0	0	0	0	0	0	2
/datadrive/data/ESAdocs/federal_register/citation.result.FR.action?federalRegister.volume=2010andfederalRegister.page=32869andpublication=FR.pdf	0	0	0	0	4	0	0	4	4
/datadrive/data/ESAdocs/federal_register/citation.result.FR.action?federalRegister.volume=2010andfederalRegister.page=34077andpublication=FR.pdf	0	0	1	2	10	0	0	13	12
/datadrive/data/ESAdocs/federal_register/citation.result.FR.action?federalRegister.volume=2010andfederalRegister.page=3424andpublication=FR.pdf	0	0	0	0	7	1	0	8	11
/datadrive/data/ESAdocs/federal_register/citation.result.FR.action?federalRegister.volume=2010andfederalRegister.page=35375andpublication=FR.pdf	0	0	0	0	19	4	1	24	23
/datadrive/data/ESAdocs/federal_register/citation.result.FR.action?federalRegister.volume=2010andfederalRegister.page=35424andpublication=FR.pdf	0	1	0	0	8	4	4	17	9
/datadrive/data/ESAdocs/federal_register/citation.result.FR.action?federalRegister.volume=2010andfederalRegister.page=35721andpublication=FR.pdf	6	0	6	7	23	0	0	42	26
/datadrive/data/ESAdocs/federal_register/citation.result.FR.action?federalRegister.volume=2010andfederalRegister.page=35746andpublication=FR.pdf	1	0	3	0	5	0	0	9	6
/datadrive/data/ESAdocs/federal_register/citation.result.FR.action?federalRegister.volume=2010andfederalRegister.page=35751andpublication=FR.pdf	0	0	1	0	11	6	6	24	13
/datadrive/data/ESAdocs/federal_register/citation.result.FR.action?federalRegister.volume=2010andfederalRegister.page=35990andpublication=FR.pdf	0	0	0	2	20	3	0	25	23
/datadrive/data/ESAdocs/federal_register/citation.result.FR.action?federalRegister.volume=2010andfederalRegister.page=36035andpublication=FR.pdf	2	0	3	1	21	11	11	49	23
/datadrive/data/ESAdocs/federal_register/citation.result.FR.action?federalRegister.volume=2010andfederalRegister.page=37460andpublication=FR.pdf	0	1	0	0	2	0	0	3	2
/datadrive/data/ESAdocs/federal_register/citation.result.FR.action?federalRegister.volume=2010andfederalRegister.page=41886andpublication=FR.pdf	0	0	0	0	2	0	0	2	2
/datadrive/data/ESAdocs/federal_register/citation.result.FR.action?federalRegister.volume=2010andfederalRegister.page=42033andpublication=FR.pdf	0	0	0	0	6	0	0	6	8
/datadrive/data/ESAdocs/federal_register/citation.result.FR.action?federalRegister.volume=2010andfederalRegister.page=42490andpublication=FR.pdf	3	0	3	0	44	1	1	52	82
/datadrive/data/ESAdocs/federal_register/citation.result.FR.action?federalRegister.volume=2010andfederalRegister.page=43844andpublication=FR.pdf	0	0	0	0	9	0	0	9	10
/datadrive/data/ESAdocs/federal_register/citation.result.FR.action?federalRegister.volume=2010andfederalRegister.page=43853andpublication=FR.pdf	3	0	4	4	12	0	0	23	12
/datadrive/data/ESAdocs/federal_register/citation.result.FR.action?federalRegister.volume=2010andfederalRegister.page=45497andpublication=FR.pdf	2	4	4	4	22	0	0	36	31
/datadrive/data/ESAdocs/federal_register/citation.result.FR.action?federalRegister.volume=2010andfederalRegister.page=46894andpublication=FR.pdf	0	0	0	0	4	0	0	4	5
/datadrive/data/ESAdocs/federal_register/citation.result.FR.action?federalRegister.volume=2010andfederalRegister.page=47025andpublication=FR.pdf	0	0	0	0	1	0	0	1	2
/datadrive/data/ESAdocs/federal_register/citation.result.FR.action?federalRegister.volume=2010andfederalRegister.page=48294andpublication=FR.pdf	0	0	0	2	3	0	0	5	5
/datadrive/data/ESAdocs/federal_register/citation.result.FR.action?federalRegister.volume=2010andfederalRegister.page=48914andpublication=FR.pdf	3	0	1	0	5	0	0	9	6
/datadrive/data/ESAdocs/federal_register/citation.result.FR.action?federalRegister.volume=2010andfederalRegister.page=50814andpublication=FR.pdf	3	2	3	0	21	2	1	32	30
/datadrive/data/ESAdocs/federal_register/citation.result.FR.action?federalRegister.volume=2010andfederalRegister.page=51204andpublication=FR.pdf	0	1	1	1	20	0	0	23	20
/datadrive/data/ESAdocs/federal_register/citation.result.FR.action?federalRegister.volume=2010andfederalRegister.page=51223andpublication=FR.pdf	0	0	1	0	14	0	0	15	15
/datadrive/data/ESAdocs/federal_register/citation.result.FR.action?federalRegister.volume=2010andfederalRegister.page=52547andpublication=FR.pdf	0	0	0	0	3	0	0	3	3
/datadrive/data/ESAdocs/federal_register/citation.result.FR.action?federalRegister.volume=2010andfederalRegister.page=5263andpublication=FR.pdf	0	0	0	0	14	9	6	29	16
/datadrive/data/ESAdocs/federal_register/citation.result.FR.action?federalRegister.volume=2010andfederalRegister.page=53598andpublication=FR.pdf	0	0	0	0	6	0	0	6	9
/datadrive/data/ESAdocs/federal_register/citation.result.FR.action?federalRegister.volume=2010andfederalRegister.page=53978andpublication=FR.pdf	0	0	0	0	2	0	0	2	2
/datadrive/data/ESAdocs/federal_register/citation.result.FR.action?federalRegister.volume=2010andfederalRegister.page=54561andpublication=FR.pdf	2	0	3	0	17	5	8	35	19
/datadrive/data/ESAdocs/federal_register/citation.result.FR.action?federalRegister.volume=2010andfederalRegister.page=54822andpublication=FR.pdf	3	1	2	1	17	0	0	24	24
/datadrive/data/ESAdocs/federal_register/citation.result.FR.action?federalRegister.volume=2010andfederalRegister.page=55686andpublication=FR.pdf	0	0	0	0	2	0	0	2	4
/datadrive/data/ESAdocs/federal_register/citation.result.FR.action?federalRegister.volume=2010andfederalRegister.page=55730andpublication=FR.pdf	0	0	0	0	6	0	0	6	6
/datadrive/data/ESAdocs/federal_register/citation.result.FR.action?federalRegister.volume=2010andfederalRegister.page=55820andpublication=FR.pdf	0	0	0	0	3	0	0	3	4
/datadrive/data/ESAdocs/federal_register/citation.result.FR.action?federalRegister.volume=2010andfederalRegister.page=56131andpublication=FR.pdf	0	0	0	0	3	0	0	3	3
/datadrive/data/ESAdocs/federal_register/citation.result.FR.action?federalRegister.volume=2010andfederalRegister.page=57055andpublication=FR.pdf	0	0	0	0	1	0	0	1	2
/datadrive/data/ESAdocs/federal_register/citation.result.FR.action?federalRegister.volume=2010andfederalRegister.page=5732andpublication=FR.pdf	3	1	0	0	12	0	0	16	14
/datadrive/data/ESAdocs/federal_register/citation.result.FR.action?federalRegister.volume=2010andfederalRegister.page=57426andpublication=FR.pdf	0	0	0	0	3	0	0	3	6
/datadrive/data/ESAdocs/federal_register/citation.result.FR.action?federalRegister.volume=2010andfederalRegister.page=57720andpublication=FR.pdf	0	1	1	0	9	0	0	11	15
/datadrive/data/ESAdocs/federal_register/citation.result.FR.action?federalRegister.volume=2010andfederalRegister.page=59645andpublication=FR.pdf	0	0	0	0	9	1	0	10	12
/datadrive/data/ESAdocs/federal_register/citation.result.FR.action?federalRegister.volume=2010andfederalRegister.page=59804andpublication=FR.pdf	14	3	2	2	49	0	0	70	61
/datadrive/data/ESAdocs/federal_register/citation.result.FR.action?federalRegister.volume=2010andfederalRegister.page=60516andpublication=FR.pdf	16	4	4	3	44	1	0	72	47
/datadrive/data/ESAdocs/federal_register/citation.result.FR.action?federalRegister.volume=2010andfederalRegister.page=606andpublication=FR.pdf	2	2	3	2	41	6	7	63	45
/datadrive/data/ESAdocs/federal_register/citation.result.FR.action?federalRegister.volume=2010andfederalRegister.page=61664andpublication=FR.pdf	4	0	0	0	19	14	12	49	27
/datadrive/data/ESAdocs/federal_register/citation.result.FR.action?federalRegister.volume=2010andfederalRegister.page=62192andpublication=FR.pdf	0	2	2	1	35	1	1	42	65
/datadrive/data/ESAdocs/federal_register/citation.result.FR.action?federalRegister.volume=2010andfederalRegister.page=62562andpublication=FR.pdf	0	0	0	0	1	0	0	1	3
/datadrive/data/ESAdocs/federal_register/citation.result.FR.action?federalRegister.volume=2010andfederalRegister.page=63898andpublication=FR.pdf	6	13	2	0	97	22	21	161	174
/datadrive/data/ESAdocs/federal_register/citation.result.FR.action?federalRegister.volume=2010andfederalRegister.page=65574andpublication=FR.pdf	0	0	0	0	4	0	0	4	6
/datadrive/data/ESAdocs/federal_register/citation.result.FR.action?federalRegister.volume=2010andfederalRegister.page=6613andpublication=FR.pdf	0	0	0	0	1	0	3	4	4
/datadrive/data/ESAdocs/federal_register/citation.result.FR.action?federalRegister.volume=2010andfederalRegister.page=66482andpublication=FR.pdf	18	0	1	2	56	17	7	101	72
/datadrive/data/ESAdocs/federal_register/citation.result.FR.action?federalRegister.volume=2010andfederalRegister.page=6696andpublication=FR.pdf	0	0	0	0	2	0	0	2	2
/datadrive/data/ESAdocs/federal_register/citation.result.FR.action?federalRegister.volume=2010andfederalRegister.page=6697andpublication=FR.pdf	0	0	0	0	2	0	0	2	2
/datadrive/data/ESAdocs/federal_register/citation.result.FR.action?federalRegister.volume=2010andfederalRegister.page=67512andpublication=FR.pdf	3	0	1	0	27	13	18	62	40
/datadrive/data/ESAdocs/federal_register/citation.result.FR.action?federalRegister.volume=2010andfederalRegister.page=67552andpublication=FR.pdf	2	0	0	1	20	11	5	39	33
/datadrive/data/ESAdocs/federal_register/citation.result.FR.action?federalRegister.volume=2010andfederalRegister.page=67925andpublication=FR.pdf	3	1	0	1	18	1	3	27	20
/datadrive/data/ESAdocs/federal_register/citation.result.FR.action?federalRegister.volume=2010andfederalRegister.page=68719andpublication=FR.pdf	0	0	0	0	5	0	0	5	7
/datadrive/data/ESAdocs/federal_register/citation.result.FR.action?federalRegister.volume=2010andfederalRegister.page=68821andpublication=FR.pdf	0	0	0	0	3	0	1	4	3
/datadrive/data/ESAdocs/federal_register/citation.result.FR.action?federalRegister.volume=2010andfederalRegister.page=69222andpublication=FR.pdf	13	5	12	13	62	10	8	123	74
/datadrive/data/ESAdocs/federal_register/citation.result.FR.action?federalRegister.volume=2010andfederalRegister.page=71726andpublication=FR.pdf	0	0	0	0	2	0	0	2	4
/datadrive/data/ESAdocs/federal_register/citation.result.FR.action?federalRegister.volume=2010andfederalRegister.page=74073andpublication=FR.pdf	0	0	0	0	3	0	0	3	3
/datadrive/data/ESAdocs/federal_register/citation.result.FR.action?federalRegister.volume=2010andfederalRegister.page=74546andpublication=FR.pdf	0	0	0	0	27	0	1	28	60
/datadrive/data/ESAdocs/federal_register/citation.result.FR.action?federalRegister.volume=2010andfederalRegister.page=75913andpublication=FR.pdf	1	0	0	0	18	8	12	39	19
/datadrive/data/ESAdocs/federal_register/citation.result.FR.action?federalRegister.volume=2010andfederalRegister.page=76086andpublication=FR.pdf	0	0	2	0	42	0	1	45	53
/datadrive/data/ESAdocs/federal_register/citation.result.FR.action?federalRegister.volume=2010andfederalRegister.page=7625andpublication=FR.pdf	0	0	0	0	2	0	1	3	2
/datadrive/data/ESAdocs/federal_register/citation.result.FR.action?federalRegister.volume=2010andfederalRegister.page=77962andpublication=FR.pdf	0	0	4	0	41	35	14	94	67
/datadrive/data/ESAdocs/federal_register/citation.result.FR.action?federalRegister.volume=2010andfederalRegister.page=78030andpublication=FR.pdf	1	2	0	0	30	0	0	33	33
/datadrive/data/ESAdocs/federal_register/citation.result.FR.action?federalRegister.volume=2010andfederalRegister.page=78430andpublication=FR.pdf	4	1	3	0	34	2	1	45	55
/datadrive/data/ESAdocs/federal_register/citation.result.FR.action?federalRegister.volume=2010andfederalRegister.page=78514andpublication=FR.pdf	15	3	3	6	36	1	0	64	44
/datadrive/data/ESAdocs/federal_register/citation.result.FR.action?federalRegister.volume=2010andfederalRegister.page=81637andpublication=FR.pdf	0	0	0	0	3	0	0	3	3
/datadrive/data/ESAdocs/federal_register/citation.result.FR.action?federalRegister.volume=2010andfederalRegister.page=8293andpublication=FR.pdf	0	0	0	0	2	0	0	2	2
/datadrive/data/ESAdocs/federal_register/citation.result.FR.action?federalRegister.volume=2010andfederalRegister.page=8736andpublication=FR.pdf	0	0	0	0	3	0	0	3	3
/datadrive/data/ESAdocs/federal_register/citation.result.FR.action?federalRegister.volume=2011andfederalRegister.page=2863andpublication=FR.pdf	0	0	0	0	7	0	0	7	9
/datadrive/data/ESAdocs/federal_register/citation.result.FR.action?federalRegister.volume=2011andfederalRegister.page=3069andpublication=FR.pdf	0	0	0	0	4	0	0	4	6
/datadrive/data/ESAdocs/federal_register/citation.result.FR.action?federalRegister.volume=2012andfederalRegister.page=38819andpublication=FR.pdf	0	0	0	0	2	0	0	2	3
/datadrive/data/ESAdocs/federal_register/citation.result.FR.action?federalRegister.volume=2012andfederalRegister.page=50526andpublication=FR.pdf	0	0	0	0	4	0	0	4	5
/datadrive/data/ESAdocs/federal_register/citation.result.FR.action?federalRegister.volume=2012andfederalRegister.page=71013andpublication=FR.pdf	0	0	0	0	2	0	0	2	3
/datadrive/data/ESAdocs/federal_register/citation.result.FR.action?federalRegister.volume=2013andfederalRegister.page=11218andpublication=FR.pdf	1	0	0	0	3	0	0	4	3
/datadrive/data/ESAdocs/federal_register/E7-17716.pdf	0	0	0	0	4	2	0	6	5
/datadrive/data/ESAdocs/federal_register/E7-19882.pdf	0	0	0	0	1	0	0	1	2
/datadrive/data/ESAdocs/federal_register/E7-24148.pdf	0	0	0	0	2	0	0	2	3
/datadrive/data/ESAdocs/federal_register/E8-17368.pdf	0	0	0	0	2	0	0	2	2
/datadrive/data/ESAdocs/federal_register/E8-31029.pdf	0	0	0	0	0	0	0	0	1
/datadrive/data/ESAdocs/federal_register/E9-30900.pdf	0	0	0	0	4	0	0	4	4
/datadrive/data/ESAdocs/federal_register/E9-30908.pdf	0	0	0	0	4	0	0	4	5
/datadrive/data/ESAdocs/federal_register/federal_register_2014-19353.pdf	2	0	0	0	40	6	3	51	40
/datadrive/data/ESAdocs/federal_register/fr1000.pdf	0	0	2	1	1	0	0	4	4
/datadrive/data/ESAdocs/federal_register/fr1001.pdf	1	0	0	0	3	0	0	4	3
/datadrive/data/ESAdocs/federal_register/fr1002.pdf	0	0	1	0	3	0	0	4	4
/datadrive/data/ESAdocs/federal_register/fr1003.pdf	0	0	1	0	1	0	0	2	4
/datadrive/data/ESAdocs/federal_register/fr1004.pdf	1	0	3	3	1	0	0	8	4
/datadrive/data/ESAdocs/federal_register/fr1005.pdf	0	0	0	0	2	0	0	2	3
/datadrive/data/ESAdocs/federal_register/fr1008.pdf	1	0	0	0	2	0	0	3	4
/datadrive/data/ESAdocs/federal_register/fr1009.pdf	0	0	0	0	2	0	0	2	2
/datadrive/data/ESAdocs/federal_register/fr100.pdf	0	0	0	0	1	0	0	1	3
/datadrive/data/ESAdocs/federal_register/fr1010.pdf	0	0	0	0	0	0	0	0	2
/datadrive/data/ESAdocs/federal_register/fr1011.pdf	0	0	0	1	4	0	0	5	4
/datadrive/data/ESAdocs/federal_register/fr1012.pdf	0	0	0	2	4	0	0	6	5
/datadrive/data/ESAdocs/federal_register/fr1014.pdf	1	1	1	1	4	0	0	8	5
/datadrive/data/ESAdocs/federal_register/fr1016.pdf	0	0	0	0	2	0	0	2	5
/datadrive/data/ESAdocs/federal_register/fr1017.pdf	0	0	0	0	1	0	0	1	4
/datadrive/data/ESAdocs/federal_register/fr1018.pdf	0	0	0	0	2	0	0	2	4
/datadrive/data/ESAdocs/federal_register/fr1021.pdf	0	0	0	0	4	0	0	4	6
/datadrive/data/ESAdocs/federal_register/fr1022.pdf	0	0	0	0	7	0	0	7	10
/datadrive/data/ESAdocs/federal_register/fr1025.pdf	1	0	1	0	6	0	1	9	7
/datadrive/data/ESAdocs/federal_register/fr1026.pdf	0	0	1	0	6	0	0	7	6
/datadrive/data/ESAdocs/federal_register/fr1027.pdf	0	0	0	0	40	0	0	40	52
/datadrive/data/ESAdocs/federal_register/fr102.pdf	0	0	0	0	1	0	0	1	3
/datadrive/data/ESAdocs/federal_register/fr103.pdf	0	0	0	0	0	0	0	0	7
/datadrive/data/ESAdocs/federal_register/fr1042.pdf	0	0	0	0	2	0	0	2	5
/datadrive/data/ESAdocs/federal_register/fr1043.pdf	0	0	0	0	4	0	0	4	4
/datadrive/data/ESAdocs/federal_register/fr1044.pdf	0	0	0	0	2	0	0	2	4
/datadrive/data/ESAdocs/federal_register/fr1046.pdf	0	0	2	0	4	0	0	6	5
/datadrive/data/ESAdocs/federal_register/fr1050.pdf	0	0	0	0	4	0	3	7	5
/datadrive/data/ESAdocs/federal_register/fr1051.pdf	2	0	0	0	2	0	0	4	4
/datadrive/data/ESAdocs/federal_register/fr1056.pdf	0	0	0	0	1	0	0	1	3
/datadrive/data/ESAdocs/federal_register/fr1057.pdf	2	0	0	1	3	0	0	6	4
/datadrive/data/ESAdocs/federal_register/fr1058.pdf	0	0	1	0	1	0	0	2	3
/datadrive/data/ESAdocs/federal_register/fr105.pdf	0	0	0	0	4	0	0	4	5
/datadrive/data/ESAdocs/federal_register/fr1060.pdf	1	0	1	0	4	0	0	6	6
/datadrive/data/ESAdocs/federal_register/fr1063.pdf	0	0	0	0	2	0	0	2	2
/datadrive/data/ESAdocs/federal_register/fr1065.pdf	0	0	0	0	4	0	0	4	7
/datadrive/data/ESAdocs/federal_register/fr1066.pdf	0	0	2	0	5	0	0	7	5
/datadrive/data/ESAdocs/federal_register/fr1067.pdf	0	0	0	0	3	1	0	4	5
/datadrive/data/ESAdocs/federal_register/fr1068.pdf	0	0	0	0	2	0	0	2	4
/datadrive/data/ESAdocs/federal_register/fr106.pdf	0	0	0	0	22	0	0	22	49
/datadrive/data/ESAdocs/federal_register/fr1071.pdf	1	0	2	1	3	0	0	7	5
/datadrive/data/ESAdocs/federal_register/fr1072.pdf	0	0	0	0	3	1	0	4	4
/datadrive/data/ESAdocs/federal_register/fr1076.pdf	0	0	0	0	3	1	2	6	4
/datadrive/data/ESAdocs/federal_register/fr1079.pdf	1	1	1	1	3	0	0	7	4
/datadrive/data/ESAdocs/federal_register/fr107.pdf	0	0	0	0	1	0	0	1	1
/datadrive/data/ESAdocs/federal_register/fr1080.pdf	0	0	0	0	1	0	2	3	4
/datadrive/data/ESAdocs/federal_register/fr1087.pdf	0	0	0	0	1	0	0	1	2
/datadrive/data/ESAdocs/federal_register/fr1088.pdf	0	0	0	0	4	0	0	4	5
/datadrive/data/ESAdocs/federal_register/fr1089.pdf	1	0	0	0	3	0	0	4	4
/datadrive/data/ESAdocs/federal_register/fr108.pdf	0	0	0	0	3	0	2	5	4
/datadrive/data/ESAdocs/federal_register/fr1092.pdf	1	0	1	2	3	0	0	7	4
/datadrive/data/ESAdocs/federal_register/fr1094.pdf	0	0	0	0	1	0	0	1	3
/datadrive/data/ESAdocs/federal_register/fr1096.pdf	0	3	1	1	4	0	0	9	7
/datadrive/data/ESAdocs/federal_register/fr1098.pdf	1	0	0	1	1	0	0	3	4
/datadrive/data/ESAdocs/federal_register/fr1099.pdf	0	0	0	0	3	0	0	3	4
/datadrive/data/ESAdocs/federal_register/fr1100.pdf	0	0	0	0	3	0	0	3	3
/datadrive/data/ESAdocs/federal_register/fr1101.pdf	1	0	1	1	2	0	0	5	4
/datadrive/data/ESAdocs/federal_register/fr1102.pdf	0	0	0	0	5	0	0	5	10
/datadrive/data/ESAdocs/federal_register/fr1103.pdf	0	0	0	0	5	0	2	7	7
/datadrive/data/ESAdocs/federal_register/fr1104.pdf	3	0	2	2	7	1	0	15	9
/datadrive/data/ESAdocs/federal_register/fr1107.pdf	0	0	0	0	6	4	2	12	8
/datadrive/data/ESAdocs/federal_register/fr1108.pdf	0	0	0	0	2	0	0	2	4
/datadrive/data/ESAdocs/federal_register/fr110.pdf	0	0	0	0	3	0	0	3	3
/datadrive/data/ESAdocs/federal_register/fr1110.pdf	0	0	1	0	4	0	0	5	5
/datadrive/data/ESAdocs/federal_register/fr1111.pdf	0	0	0	1	3	1	0	5	4
/datadrive/data/ESAdocs/federal_register/fr1113.pdf	0	0	0	1	6	0	0	7	8
/datadrive/data/ESAdocs/federal_register/fr1114.pdf	0	0	0	0	4	0	0	4	5
/datadrive/data/ESAdocs/federal_register/fr1115.pdf	0	0	0	0	2	0	0	2	3
/datadrive/data/ESAdocs/federal_register/fr1116.pdf	2	0	1	0	2	0	0	5	4
/datadrive/data/ESAdocs/federal_register/fr1117.pdf	0	0	1	1	2	0	0	4	4
/datadrive/data/ESAdocs/federal_register/fr1119.pdf	0	0	0	0	1	0	0	1	4
/datadrive/data/ESAdocs/federal_register/fr111.pdf	0	0	0	0	2	0	0	2	3
/datadrive/data/ESAdocs/federal_register/fr1122.pdf	0	0	0	0	1	0	0	1	4
/datadrive/data/ESAdocs/federal_register/fr1124.pdf	0	0	0	0	2	0	0	2	4
/datadrive/data/ESAdocs/federal_register/fr1125.pdf	1	0	0	0	5	1	1	8	6
/datadrive/data/ESAdocs/federal_register/fr1128.pdf	0	0	0	0	1	0	0	1	3
/datadrive/data/ESAdocs/federal_register/fr1129.pdf	1	0	0	0	7	0	0	8	8
/datadrive/data/ESAdocs/federal_register/fr1131.pdf	0	0	0	0	4	0	0	4	5
/datadrive/data/ESAdocs/federal_register/fr1132.pdf	0	0	0	0	2	1	1	4	4
/datadrive/data/ESAdocs/federal_register/fr1133.pdf	0	0	0	1	3	0	0	4	4
/datadrive/data/ESAdocs/federal_register/fr1135.pdf	0	0	0	0	3	0	0	3	4
/datadrive/data/ESAdocs/federal_register/fr1136.pdf	0	0	2	0	2	0	0	4	4
/datadrive/data/ESAdocs/federal_register/fr1138.pdf	0	0	0	0	3	0	0	3	4
/datadrive/data/ESAdocs/federal_register/fr1140.pdf	0	0	0	0	2	0	1	3	4
/datadrive/data/ESAdocs/federal_register/fr1141.pdf	0	0	0	0	4	0	0	4	4
/datadrive/data/ESAdocs/federal_register/fr1142.pdf	0	0	0	0	5	0	0	5	5
/datadrive/data/ESAdocs/federal_register/fr1144.pdf	0	0	0	0	3	0	0	3	6
/datadrive/data/ESAdocs/federal_register/fr1149.pdf	1	0	0	0	3	0	0	4	4
/datadrive/data/ESAdocs/federal_register/fr1150.pdf	0	0	0	0	3	0	0	3	5
/datadrive/data/ESAdocs/federal_register/fr1151.pdf	0	0	0	0	5	4	1	10	7
/datadrive/data/ESAdocs/federal_register/fr1153.pdf	2	0	1	0	4	0	0	7	5
/datadrive/data/ESAdocs/federal_register/fr1156.pdf	0	0	0	0	3	0	0	3	4
/datadrive/data/ESAdocs/federal_register/fr1157.pdf	0	2	3	0	3	0	0	8	4
/datadrive/data/ESAdocs/federal_register/fr1158.pdf	0	0	0	0	2	0	0	2	5
/datadrive/data/ESAdocs/federal_register/fr1159.pdf	0	0	0	0	3	0	0	3	5
/datadrive/data/ESAdocs/federal_register/fr115.pdf	0	0	0	0	1	0	0	1	3
/datadrive/data/ESAdocs/federal_register/fr1160.pdf	0	0	0	0	4	0	2	6	5
/datadrive/data/ESAdocs/federal_register/fr1161.pdf	2	0	0	0	4	0	0	6	6
/datadrive/data/ESAdocs/federal_register/fr1162.pdf	2	0	0	0	6	0	0	8	6
/datadrive/data/ESAdocs/federal_register/fr1168.pdf	0	0	2	0	4	0	0	6	4
/datadrive/data/ESAdocs/federal_register/fr1169.pdf	0	0	2	1	2	0	0	5	6
/datadrive/data/ESAdocs/federal_register/fr1173.pdf	0	0	0	0	0	0	0	0	3
/datadrive/data/ESAdocs/federal_register/fr1179.pdf	2	0	0	0	6	0	0	8	8
/datadrive/data/ESAdocs/federal_register/fr1180.pdf	0	0	0	1	2	0	0	3	4
/datadrive/data/ESAdocs/federal_register/fr1181.pdf	0	0	0	1	3	0	0	4	4
/datadrive/data/ESAdocs/federal_register/fr1183.pdf	0	0	0	0	1	0	3	4	3
/datadrive/data/ESAdocs/federal_register/fr1184.pdf	0	0	2	0	2	0	0	4	4
/datadrive/data/ESAdocs/federal_register/fr1185.pdf	0	0	2	0	3	0	0	5	6
/datadrive/data/ESAdocs/federal_register/fr1186.pdf	0	0	1	0	1	0	0	2	3
/datadrive/data/ESAdocs/federal_register/fr1192.pdf	0	0	0	1	4	0	0	5	4
/datadrive/data/ESAdocs/federal_register/fr1193.pdf	0	0	0	0	5	0	0	5	5
/datadrive/data/ESAdocs/federal_register/fr1195.pdf	4	0	0	0	6	0	0	10	8
/datadrive/data/ESAdocs/federal_register/fr1196.pdf	1	0	0	0	2	0	0	3	4
/datadrive/data/ESAdocs/federal_register/fr1197.pdf	0	0	0	0	2	0	0	2	3
/datadrive/data/ESAdocs/federal_register/fr119.pdf	0	0	0	0	2	0	0	2	3
/datadrive/data/ESAdocs/federal_register/fr11.pdf	0	0	0	0	1	0	0	1	4
/datadrive/data/ESAdocs/federal_register/fr1202.pdf	0	1	1	1	4	0	0	7	5
/datadrive/data/ESAdocs/federal_register/fr1203.pdf	1	0	0	2	3	0	0	6	4
/datadrive/data/ESAdocs/federal_register/fr1204.pdf	0	0	0	0	4	2	2	8	4
/datadrive/data/ESAdocs/federal_register/fr1205.pdf	0	0	0	0	2	0	0	2	4
/datadrive/data/ESAdocs/federal_register/fr1208.pdf	2	0	0	1	5	0	0	8	6
/datadrive/data/ESAdocs/federal_register/fr1209.pdf	2	0	0	1	3	0	0	6	4
/datadrive/data/ESAdocs/federal_register/fr120.pdf	0	0	0	0	1	0	0	1	1
/datadrive/data/ESAdocs/federal_register/fr1211.pdf	0	0	0	0	1	0	0	1	5
/datadrive/data/ESAdocs/federal_register/fr1212.pdf	0	0	0	0	2	0	0	2	4
/datadrive/data/ESAdocs/federal_register/fr1213.pdf	2	0	0	1	2	0	0	5	5
/datadrive/data/ESAdocs/federal_register/fr1216.pdf	1	0	1	0	2	0	0	4	4
/datadrive/data/ESAdocs/federal_register/fr1217.pdf	0	0	0	0	2	0	0	2	4
/datadrive/data/ESAdocs/federal_register/fr1218.pdf	1	0	1	1	3	0	0	6	4
/datadrive/data/ESAdocs/federal_register/fr1219.pdf	0	0	0	2	5	0	0	7	8
/datadrive/data/ESAdocs/federal_register/fr121.pdf	0	0	0	0	3	0	0	3	4
/datadrive/data/ESAdocs/federal_register/fr1220.pdf	0	0	1	0	2	0	0	3	4
/datadrive/data/ESAdocs/federal_register/fr1221.pdf	0	0	0	0	3	0	0	3	5
/datadrive/data/ESAdocs/federal_register/fr1224.pdf	0	0	0	0	2	0	0	2	4
/datadrive/data/ESAdocs/federal_register/fr1226.pdf	0	0	2	1	6	0	0	9	6
/datadrive/data/ESAdocs/federal_register/fr1227.pdf	0	0	0	2	1	0	0	3	4
/datadrive/data/ESAdocs/federal_register/fr1228.pdf	1	0	0	0	7	0	1	9	9
/datadrive/data/ESAdocs/federal_register/fr1229.pdf	0	0	0	0	7	0	0	7	8
/datadrive/data/ESAdocs/federal_register/fr1232.pdf	0	0	0	0	0	0	0	0	1
/datadrive/data/ESAdocs/federal_register/fr1234.pdf	0	0	0	1	3	1	0	5	3
/datadrive/data/ESAdocs/federal_register/fr1241.pdf	0	0	0	0	6	4	2	12	8
/datadrive/data/ESAdocs/federal_register/fr1242.pdf	0	0	0	0	2	1	2	5	3
/datadrive/data/ESAdocs/federal_register/fr1243.pdf	0	0	0	0	1	0	0	1	4
/datadrive/data/ESAdocs/federal_register/fr1244.pdf	0	0	0	0	8	0	8	16	10
/datadrive/data/ESAdocs/federal_register/fr1245.pdf	1	0	0	0	3	0	0	4	4
/datadrive/data/ESAdocs/federal_register/fr1247.pdf	0	0	0	2	4	0	0	6	4
/datadrive/data/ESAdocs/federal_register/fr1249.pdf	0	0	0	0	2	0	0	2	3
/datadrive/data/ESAdocs/federal_register/fr124.pdf	0	0	0	0	2	0	0	2	2
/datadrive/data/ESAdocs/federal_register/fr1250.pdf	0	0	0	0	2	0	0	2	3
/datadrive/data/ESAdocs/federal_register/fr1251.pdf	0	0	0	0	3	2	0	5	4
/datadrive/data/ESAdocs/federal_register/fr1252.pdf	0	0	0	1	1	0	0	2	3
/datadrive/data/ESAdocs/federal_register/fr1254.pdf	0	0	0	0	2	0	0	2	5
/datadrive/data/ESAdocs/federal_register/fr125.pdf	0	0	0	0	3	0	0	3	3
/datadrive/data/ESAdocs/federal_register/fr1261.pdf	0	0	0	0	4	0	0	4	5
/datadrive/data/ESAdocs/federal_register/fr1262.pdf	0	0	0	0	6	0	0	6	6
/datadrive/data/ESAdocs/federal_register/fr1263.pdf	0	0	0	0	6	0	0	6	6
/datadrive/data/ESAdocs/federal_register/fr1265.pdf	0	0	0	2	3	0	0	5	4
/datadrive/data/ESAdocs/federal_register/fr1266.pdf	0	0	0	1	3	1	0	5	4
/datadrive/data/ESAdocs/federal_register/fr1268.pdf	0	0	0	0	11	7	5	23	13
/datadrive/data/ESAdocs/federal_register/fr1269.pdf	0	0	0	0	4	1	2	7	6
/datadrive/data/ESAdocs/federal_register/fr126.pdf	0	0	0	0	2	0	0	2	2
/datadrive/data/ESAdocs/federal_register/fr1270.pdf	0	0	0	0	4	0	0	4	5
/datadrive/data/ESAdocs/federal_register/fr1271.pdf	0	0	1	1	2	0	0	4	4
/datadrive/data/ESAdocs/federal_register/fr1272.pdf	0	0	0	0	0	0	0	0	4
/datadrive/data/ESAdocs/federal_register/fr1273.pdf	0	0	0	1	2	0	0	3	4
/datadrive/data/ESAdocs/federal_register/fr1274.pdf	0	0	0	0	2	0	0	2	4
/datadrive/data/ESAdocs/federal_register/fr1275.pdf	0	0	0	0	1	0	0	1	3
/datadrive/data/ESAdocs/federal_register/fr1281.pdf	0	0	0	0	0	0	0	0	3
/datadrive/data/ESAdocs/federal_register/fr1282.pdf	0	0	0	0	2	0	0	2	4
/datadrive/data/ESAdocs/federal_register/fr1283.pdf	0	0	0	0	4	0	0	4	4
/datadrive/data/ESAdocs/federal_register/fr1284.pdf	0	0	0	0	1	0	0	1	4
/datadrive/data/ESAdocs/federal_register/fr1285.pdf	0	0	0	2	0	0	0	2	4
/datadrive/data/ESAdocs/federal_register/fr1286.pdf	1	0	0	0	2	0	0	3	5
/datadrive/data/ESAdocs/federal_register/fr1287.pdf	0	0	0	0	2	0	0	2	4
/datadrive/data/ESAdocs/federal_register/fr1288.pdf	0	0	0	0	3	0	0	3	5
/datadrive/data/ESAdocs/federal_register/fr128.pdf	0	0	0	0	0	0	0	0	2
/datadrive/data/ESAdocs/federal_register/fr1294.pdf	1	0	0	0	3	0	1	5	5
/datadrive/data/ESAdocs/federal_register/fr1295.pdf	0	0	0	0	1	0	0	1	4
/datadrive/data/ESAdocs/federal_register/fr1299.pdf	2	0	1	1	3	0	0	7	4
/datadrive/data/ESAdocs/federal_register/fr129.pdf	0	0	0	0	1	0	0	1	4
/datadrive/data/ESAdocs/federal_register/fr1301.pdf	0	0	0	2	3	0	0	5	4
/datadrive/data/ESAdocs/federal_register/fr1306.pdf	4	0	2	2	5	0	0	13	7
/datadrive/data/ESAdocs/federal_register/fr1307.pdf	0	0	0	0	0	0	0	0	2
/datadrive/data/ESAdocs/federal_register/fr1308.pdf	0	0	0	0	3	0	0	3	4
/datadrive/data/ESAdocs/federal_register/fr1310.pdf	0	0	0	0	17	0	0	17	31
/datadrive/data/ESAdocs/federal_register/fr1312.pdf	0	0	0	0	3	0	0	3	3
/datadrive/data/ESAdocs/federal_register/fr1313.pdf	0	0	0	0	3	0	0	3	3
/datadrive/data/ESAdocs/federal_register/fr1315.pdf	0	0	0	0	3	0	0	3	3
/datadrive/data/ESAdocs/federal_register/fr1316.pdf	2	1	0	0	3	0	1	7	5
/datadrive/data/ESAdocs/federal_register/fr1317.pdf	0	0	0	0	3	0	0	3	4
/datadrive/data/ESAdocs/federal_register/fr1318.pdf	0	0	0	0	3	0	1	4	4
/datadrive/data/ESAdocs/federal_register/fr1320.pdf	0	0	0	0	3	0	0	3	4
/datadrive/data/ESAdocs/federal_register/fr1322.pdf	0	0	0	0	0	0	0	0	2
/datadrive/data/ESAdocs/federal_register/fr1323.pdf	2	0	1	1	3	0	0	7	4
/datadrive/data/ESAdocs/federal_register/fr1324.pdf	0	0	0	1	2	0	0	3	4
/datadrive/data/ESAdocs/federal_register/fr1325.pdf	2	0	0	0	8	1	0	11	8
/datadrive/data/ESAdocs/federal_register/fr1326.pdf	0	0	0	0	2	0	0	2	5
/datadrive/data/ESAdocs/federal_register/fr1327.pdf	2	0	0	0	10	0	0	12	13
/datadrive/data/ESAdocs/federal_register/fr132.pdf	0	0	1	0	2	0	0	3	5
/datadrive/data/ESAdocs/federal_register/fr1330.pdf	0	0	0	0	4	0	1	5	6
/datadrive/data/ESAdocs/federal_register/fr1331.pdf	0	0	0	1	5	0	0	6	5
/datadrive/data/ESAdocs/federal_register/fr1332.pdf	0	0	0	0	0	0	0	0	6
/datadrive/data/ESAdocs/federal_register/fr1334.pdf	2	0	2	1	4	0	0	9	5
/datadrive/data/ESAdocs/federal_register/fr1337.pdf	2	1	1	0	4	0	0	8	5
/datadrive/data/ESAdocs/federal_register/fr1338.pdf	0	1	2	1	4	0	0	8	4
/datadrive/data/ESAdocs/federal_register/fr1339.pdf	0	2	0	0	3	0	1	6	4
/datadrive/data/ESAdocs/federal_register/fr133.pdf	1	0	1	0	4	0	0	6	4
/datadrive/data/ESAdocs/federal_register/fr1342.pdf	0	0	0	1	3	0	0	4	4
/datadrive/data/ESAdocs/federal_register/fr1345.pdf	4	0	1	0	4	0	0	9	7
/datadrive/data/ESAdocs/federal_register/fr1346.pdf	0	0	0	0	4	0	0	4	5
/datadrive/data/ESAdocs/federal_register/fr1347.pdf	0	0	0	1	4	0	0	5	4
/datadrive/data/ESAdocs/federal_register/fr1348.pdf	1	2	1	1	3	0	0	8	6
/datadrive/data/ESAdocs/federal_register/fr1349.pdf	0	0	0	0	4	0	0	4	5
/datadrive/data/ESAdocs/federal_register/fr134.pdf	0	0	0	0	4	2	0	6	4
/datadrive/data/ESAdocs/federal_register/fr1350.pdf	0	0	0	0	3	0	1	4	3
/datadrive/data/ESAdocs/federal_register/fr1352.pdf	0	0	0	2	1	0	0	3	5
/datadrive/data/ESAdocs/federal_register/fr1353.pdf	0	2	2	0	4	0	0	8	4
/datadrive/data/ESAdocs/federal_register/fr1354.pdf	0	0	0	0	3	0	0	3	4
/datadrive/data/ESAdocs/federal_register/fr1355.pdf	0	0	0	0	0	0	0	0	2
/datadrive/data/ESAdocs/federal_register/fr1356.pdf	1	0	0	0	1	0	0	2	4
/datadrive/data/ESAdocs/federal_register/fr1357.pdf	0	0	1	0	3	0	0	4	4
/datadrive/data/ESAdocs/federal_register/fr1363.pdf	0	0	0	0	0	0	0	0	3
/datadrive/data/ESAdocs/federal_register/fr1364.pdf	0	0	0	0	1	0	1	2	3
/datadrive/data/ESAdocs/federal_register/fr137.pdf	0	0	0	0	2	0	0	2	2
/datadrive/data/ESAdocs/federal_register/fr1389.pdf	0	0	2	1	5	0	0	8	6
/datadrive/data/ESAdocs/federal_register/fr138.pdf	0	0	0	0	1	0	0	1	3
/datadrive/data/ESAdocs/federal_register/fr1390.pdf	0	0	0	0	2	0	0	2	3
/datadrive/data/ESAdocs/federal_register/fr1391.pdf	0	0	0	0	3	1	0	4	4
/datadrive/data/ESAdocs/federal_register/fr1393.pdf	0	0	0	2	3	0	0	5	5
/datadrive/data/ESAdocs/federal_register/fr1397.pdf	0	0	0	0	3	0	0	3	5
/datadrive/data/ESAdocs/federal_register/fr1398.pdf	1	0	0	1	3	0	2	7	6
/datadrive/data/ESAdocs/federal_register/fr1399.pdf	0	0	0	0	2	2	0	4	4
/datadrive/data/ESAdocs/federal_register/fr1404.pdf	0	0	0	0	1	0	0	1	3
/datadrive/data/ESAdocs/federal_register/fr1409.pdf	1	0	3	1	3	0	0	8	6
/datadrive/data/ESAdocs/federal_register/fr140.pdf	2	0	0	0	6	0	0	8	7
/datadrive/data/ESAdocs/federal_register/fr1411.pdf	0	0	0	0	1	0	0	1	3
/datadrive/data/ESAdocs/federal_register/fr1412.pdf	0	0	0	1	1	0	0	2	4
/datadrive/data/ESAdocs/federal_register/fr1414.pdf	0	0	0	0	1	1	0	2	4
/datadrive/data/ESAdocs/federal_register/fr1415.pdf	0	0	0	0	2	0	0	2	4
/datadrive/data/ESAdocs/federal_register/fr1416.pdf	0	0	2	0	3	0	1	6	4
/datadrive/data/ESAdocs/federal_register/fr1417.pdf	0	0	0	0	3	0	3	6	5
/datadrive/data/ESAdocs/federal_register/fr1418.pdf	0	0	1	1	2	0	0	4	5
/datadrive/data/ESAdocs/federal_register/fr1424.pdf	0	0	0	0	1	0	0	1	11
/datadrive/data/ESAdocs/federal_register/fr1429.pdf	0	0	0	0	1	0	0	1	3
/datadrive/data/ESAdocs/federal_register/fr1430.pdf	0	0	0	0	4	0	0	4	4
/datadrive/data/ESAdocs/federal_register/fr1431.pdf	0	0	0	3	1	0	0	4	4
/datadrive/data/ESAdocs/federal_register/fr1433.pdf	0	0	0	0	5	1	0	6	5
/datadrive/data/ESAdocs/federal_register/fr1434.pdf	0	0	0	0	3	0	0	3	6
/datadrive/data/ESAdocs/federal_register/fr1435.pdf	0	0	0	0	1	0	0	1	5
/datadrive/data/ESAdocs/federal_register/fr1436.pdf	0	0	0	0	2	0	0	2	4
/datadrive/data/ESAdocs/federal_register/fr1442.pdf	2	1	0	0	3	0	0	6	5
/datadrive/data/ESAdocs/federal_register/fr1443.pdf	0	0	0	0	3	0	0	3	4
/datadrive/data/ESAdocs/federal_register/fr1444.pdf	0	0	0	2	3	0	0	5	5
/datadrive/data/ESAdocs/federal_register/fr1445.pdf	0	0	0	0	3	0	1	4	5
/datadrive/data/ESAdocs/federal_register/fr1446.pdf	3	0	0	1	5	0	0	9	5
/datadrive/data/ESAdocs/federal_register/fr1447.pdf	0	0	0	0	3	0	2	5	4
/datadrive/data/ESAdocs/federal_register/fr1449.pdf	0	0	0	0	3	0	0	3	3
/datadrive/data/ESAdocs/federal_register/fr1453.pdf	0	0	0	0	0	0	0	0	3
/datadrive/data/ESAdocs/federal_register/fr1455.pdf	1	1	1	0	3	0	0	6	4
/datadrive/data/ESAdocs/federal_register/fr1456.pdf	1	0	0	0	0	0	0	1	4
/datadrive/data/ESAdocs/federal_register/fr1462.pdf	0	0	0	1	3	0	0	4	5
/datadrive/data/ESAdocs/federal_register/fr1463.pdf	0	0	0	0	3	0	1	4	3
/datadrive/data/ESAdocs/federal_register/fr1464.pdf	0	0	0	0	2	0	0	2	4
/datadrive/data/ESAdocs/federal_register/fr1465.pdf	0	0	0	0	2	0	0	2	3
/datadrive/data/ESAdocs/federal_register/fr1466.pdf	0	0	1	0	4	0	0	5	4
/datadrive/data/ESAdocs/federal_register/fr1467.pdf	0	2	2	0	3	0	0	7	5
/datadrive/data/ESAdocs/federal_register/fr1468.pdf	0	0	0	0	2	2	0	4	5
/datadrive/data/ESAdocs/federal_register/fr146.pdf	0	0	0	0	1	0	0	1	3
/datadrive/data/ESAdocs/federal_register/fr1470.pdf	1	0	3	1	3	0	0	8	5
/datadrive/data/ESAdocs/federal_register/fr1473.pdf	0	0	0	0	2	1	0	3	5
/datadrive/data/ESAdocs/federal_register/fr1475.pdf	0	0	0	0	3	0	0	3	5
/datadrive/data/ESAdocs/federal_register/fr1476.pdf	0	0	0	0	2	0	0	2	5
/datadrive/data/ESAdocs/federal_register/fr1477.pdf	0	0	0	0	4	0	0	4	5
/datadrive/data/ESAdocs/federal_register/fr1478.pdf	0	0	0	0	2	0	1	3	3
/datadrive/data/ESAdocs/federal_register/fr1479.pdf	1	0	0	0	2	0	0	3	3
/datadrive/data/ESAdocs/federal_register/fr1480.pdf	0	0	0	0	4	0	0	4	4
/datadrive/data/ESAdocs/federal_register/fr1481.pdf	0	0	0	0	2	0	0	2	4
/datadrive/data/ESAdocs/federal_register/fr1482.pdf	1	0	0	1	4	0	1	7	5
/datadrive/data/ESAdocs/federal_register/fr1484.pdf	2	0	0	0	3	0	0	5	4
/datadrive/data/ESAdocs/federal_register/fr1486.pdf	0	0	0	0	3	0	0	3	4
/datadrive/data/ESAdocs/federal_register/fr1487.pdf	2	0	0	0	3	0	0	5	5
/datadrive/data/ESAdocs/federal_register/fr1488.pdf	1	0	1	0	4	0	1	7	6
/datadrive/data/ESAdocs/federal_register/fr1489.pdf	0	0	0	0	4	0	0	4	6
/datadrive/data/ESAdocs/federal_register/fr148.pdf	0	0	0	0	2	0	0	2	4
/datadrive/data/ESAdocs/federal_register/fr1490.pdf	1	0	0	1	2	0	0	4	5
/datadrive/data/ESAdocs/federal_register/fr1492.pdf	0	0	0	0	1	0	0	1	2
/datadrive/data/ESAdocs/federal_register/fr1493.pdf	0	0	0	0	1	0	0	1	5
/datadrive/data/ESAdocs/federal_register/fr1494.pdf	1	0	0	0	5	0	0	6	6
/datadrive/data/ESAdocs/federal_register/fr1496.pdf	0	0	0	0	0	0	0	0	1
/datadrive/data/ESAdocs/federal_register/fr1497.pdf	2	0	0	0	6	1	0	9	6
/datadrive/data/ESAdocs/federal_register/fr1498.pdf	0	0	0	0	1	0	0	1	1
/datadrive/data/ESAdocs/federal_register/fr1499.pdf	0	0	0	0	3	0	0	3	4
/datadrive/data/ESAdocs/federal_register/fr1500.pdf	0	0	0	0	3	0	2	5	5
/datadrive/data/ESAdocs/federal_register/fr1501.pdf	2	1	0	0	4	0	0	7	4
/datadrive/data/ESAdocs/federal_register/fr1506.pdf	0	0	0	0	0	0	0	0	2
/datadrive/data/ESAdocs/federal_register/fr1507.pdf	0	0	0	0	1	0	0	1	4
/datadrive/data/ESAdocs/federal_register/fr1508.pdf	0	0	0	0	2	0	0	2	2
/datadrive/data/ESAdocs/federal_register/fr1509.pdf	0	0	0	0	2	0	0	2	5
/datadrive/data/ESAdocs/federal_register/fr150.pdf	0	0	0	0	0	0	0	0	4
/datadrive/data/ESAdocs/federal_register/fr1513.pdf	1	0	2	2	3	0	0	8	4
/datadrive/data/ESAdocs/federal_register/fr1516.pdf	0	0	1	0	2	0	0	3	5
/datadrive/data/ESAdocs/federal_register/fr1517.pdf	0	0	0	0	3	0	0	3	4
/datadrive/data/ESAdocs/federal_register/fr1518.pdf	0	0	1	1	1	0	0	3	4
/datadrive/data/ESAdocs/federal_register/fr1519.pdf	0	0	0	0	2	0	1	3	4
/datadrive/data/ESAdocs/federal_register/fr151.pdf	0	0	0	0	1	0	0	1	6
/datadrive/data/ESAdocs/federal_register/fr1520.pdf	0	0	0	0	4	0	2	6	5
/datadrive/data/ESAdocs/federal_register/fr1522.pdf	0	0	0	0	0	0	0	0	2
/datadrive/data/ESAdocs/federal_register/fr1524.pdf	0	0	0	0	2	0	2	4	4
/datadrive/data/ESAdocs/federal_register/fr1528.pdf	0	0	0	0	3	0	2	5	5
/datadrive/data/ESAdocs/federal_register/fr1529.pdf	0	0	1	1	3	0	0	5	5
/datadrive/data/ESAdocs/federal_register/fr152.pdf	0	0	0	0	1	0	0	1	1
/datadrive/data/ESAdocs/federal_register/fr1535.pdf	0	0	2	0	3	0	0	5	4
/datadrive/data/ESAdocs/federal_register/fr1536.pdf	0	0	0	0	1	0	0	1	4
/datadrive/data/ESAdocs/federal_register/fr1538.pdf	0	0	0	0	3	1	1	5	5
/datadrive/data/ESAdocs/federal_register/fr1542.pdf	0	0	0	0	4	0	0	4	5
/datadrive/data/ESAdocs/federal_register/fr1543.pdf	0	0	2	2	3	0	0	7	4
/datadrive/data/ESAdocs/federal_register/fr1544.pdf	0	0	3	3	3	0	0	9	5
/datadrive/data/ESAdocs/federal_register/fr1546.pdf	0	0	1	0	4	0	0	5	6
/datadrive/data/ESAdocs/federal_register/fr1548.pdf	0	0	0	0	1	0	0	1	2
/datadrive/data/ESAdocs/federal_register/fr1551.pdf	0	0	0	0	4	0	0	4	5
/datadrive/data/ESAdocs/federal_register/fr1552.pdf	0	0	0	0	9	0	0	9	12
/datadrive/data/ESAdocs/federal_register/fr1559.pdf	0	0	0	0	1	0	0	1	4
/datadrive/data/ESAdocs/federal_register/fr1560.pdf	2	1	0	0	4	0	0	7	4
/datadrive/data/ESAdocs/federal_register/fr1561.pdf	0	0	0	0	6	1	0	7	6
/datadrive/data/ESAdocs/federal_register/fr1562.pdf	0	0	0	3	3	0	0	6	5
/datadrive/data/ESAdocs/federal_register/fr1564.pdf	1	0	0	1	4	0	0	6	5
/datadrive/data/ESAdocs/federal_register/fr1565.pdf	0	0	0	3	2	1	0	6	6
/datadrive/data/ESAdocs/federal_register/fr1566.pdf	0	0	0	0	5	0	0	5	5
/datadrive/data/ESAdocs/federal_register/fr1567.pdf	2	0	2	1	4	0	0	9	7
/datadrive/data/ESAdocs/federal_register/fr1568.pdf	5	1	0	1	8	0	0	15	9
/datadrive/data/ESAdocs/federal_register/fr1569.pdf	0	0	0	0	3	1	2	6	4
/datadrive/data/ESAdocs/federal_register/fr156.pdf	0	0	0	0	3	0	2	5	3
/datadrive/data/ESAdocs/federal_register/fr1570.pdf	1	0	0	0	5	2	2	10	5
/datadrive/data/ESAdocs/federal_register/fr1571.pdf	0	0	0	0	1	0	0	1	3
/datadrive/data/ESAdocs/federal_register/fr1572.pdf	0	0	0	0	4	0	0	4	4
/datadrive/data/ESAdocs/federal_register/fr1573.pdf	1	2	1	1	4	0	0	9	6
/datadrive/data/ESAdocs/federal_register/fr1578.pdf	0	0	0	0	0	0	0	0	2
/datadrive/data/ESAdocs/federal_register/fr1580.pdf	0	0	0	0	4	0	0	4	5
/datadrive/data/ESAdocs/federal_register/fr1581.pdf	0	0	0	0	3	0	1	4	5
/datadrive/data/ESAdocs/federal_register/fr1582.pdf	0	0	0	0	3	0	0	3	5
/datadrive/data/ESAdocs/federal_register/fr1584.pdf	2	0	1	1	4	0	0	8	4
/datadrive/data/ESAdocs/federal_register/fr1585.pdf	0	0	0	0	3	1	2	6	7
/datadrive/data/ESAdocs/federal_register/fr1586.pdf	0	0	0	0	4	0	2	6	5
/datadrive/data/ESAdocs/federal_register/fr1587.pdf	0	0	0	0	2	0	0	2	4
/datadrive/data/ESAdocs/federal_register/fr158.pdf	0	0	0	0	2	0	2	4	3
/datadrive/data/ESAdocs/federal_register/fr1595.pdf	0	0	0	0	2	0	0	2	2
/datadrive/data/ESAdocs/federal_register/fr1596.pdf	0	0	2	0	2	0	0	4	3
/datadrive/data/ESAdocs/federal_register/fr1597.pdf	0	0	2	0	2	0	0	4	4
/datadrive/data/ESAdocs/federal_register/fr1598.pdf	0	0	0	0	0	0	0	0	2
/datadrive/data/ESAdocs/federal_register/fr1599.pdf	0	0	0	0	5	0	3	8	5
/datadrive/data/ESAdocs/federal_register/fr159.pdf	0	0	0	0	3	0	1	4	5
/datadrive/data/ESAdocs/federal_register/fr1600.pdf	0	0	0	0	4	0	1	5	4
/datadrive/data/ESAdocs/federal_register/fr1601.pdf	0	0	0	0	4	0	0	4	5
/datadrive/data/ESAdocs/federal_register/fr1602.pdf	1	0	0	0	6	0	0	7	7
/datadrive/data/ESAdocs/federal_register/fr1603.pdf	0	0	0	0	3	0	2	5	4
/datadrive/data/ESAdocs/federal_register/fr1606.pdf	0	0	0	0	3	0	0	3	4
/datadrive/data/ESAdocs/federal_register/fr1607.pdf	0	0	1	0	4	0	0	5	4
/datadrive/data/ESAdocs/federal_register/fr1608.pdf	0	0	0	0	5	0	1	6	5
/datadrive/data/ESAdocs/federal_register/fr1609.pdf	0	0	0	0	4	0	0	4	5
/datadrive/data/ESAdocs/federal_register/fr1610.pdf	0	0	0	0	4	0	0	4	6
/datadrive/data/ESAdocs/federal_register/fr1613.pdf	0	0	0	0	3	0	0	3	6
/datadrive/data/ESAdocs/federal_register/fr1614.pdf	0	0	1	0	3	0	0	4	3
/datadrive/data/ESAdocs/federal_register/fr1615.pdf	0	0	3	1	6	0	0	10	7
/datadrive/data/ESAdocs/federal_register/fr1617.pdf	4	2	2	1	7	0	0	16	9
/datadrive/data/ESAdocs/federal_register/fr1618.pdf	2	0	0	0	4	0	0	6	6
/datadrive/data/ESAdocs/federal_register/fr161.pdf	0	0	0	0	1	0	0	1	6
/datadrive/data/ESAdocs/federal_register/fr1620.pdf	0	0	0	1	2	0	0	3	4
/datadrive/data/ESAdocs/federal_register/fr1621.pdf	0	0	0	1	1	0	0	2	1
/datadrive/data/ESAdocs/federal_register/fr1622.pdf	0	0	0	1	3	0	1	5	5
/datadrive/data/ESAdocs/federal_register/fr1623.pdf	0	0	0	2	3	0	0	5	3
/datadrive/data/ESAdocs/federal_register/fr1624.pdf	0	0	0	0	4	2	0	6	5
/datadrive/data/ESAdocs/federal_register/fr1625.pdf	0	0	0	0	5	0	0	5	5
/datadrive/data/ESAdocs/federal_register/fr162.pdf	0	0	0	0	2	0	0	2	2
/datadrive/data/ESAdocs/federal_register/fr1630.pdf	0	0	0	0	1	0	0	1	1
/datadrive/data/ESAdocs/federal_register/fr1634.pdf	0	0	0	1	2	0	0	3	4
/datadrive/data/ESAdocs/federal_register/fr163.pdf	0	0	0	0	2	0	0	2	3
/datadrive/data/ESAdocs/federal_register/fr1640.pdf	0	0	0	0	1	0	0	1	3
/datadrive/data/ESAdocs/federal_register/fr1644.pdf	0	0	3	3	4	0	0	10	5
/datadrive/data/ESAdocs/federal_register/fr1651.pdf	1	0	0	1	5	0	0	7	6
/datadrive/data/ESAdocs/federal_register/fr1652.pdf	0	0	1	1	2	0	0	4	3
/datadrive/data/ESAdocs/federal_register/fr1656.pdf	1	0	0	0	3	0	0	4	3
/datadrive/data/ESAdocs/federal_register/fr1657.pdf	0	0	0	0	36	0	0	36	46
/datadrive/data/ESAdocs/federal_register/fr1664.pdf	0	0	0	0	3	1	1	5	5
/datadrive/data/ESAdocs/federal_register/fr1665.pdf	0	0	0	0	2	0	0	2	4
/datadrive/data/ESAdocs/federal_register/fr1666.pdf	0	0	2	2	1	0	2	7	4
/datadrive/data/ESAdocs/federal_register/fr1667.pdf	0	0	0	0	2	1	3	6	5
/datadrive/data/ESAdocs/federal_register/fr1668.pdf	0	0	0	0	8	0	1	9	8
/datadrive/data/ESAdocs/federal_register/fr1669.pdf	3	0	0	0	4	0	0	7	5
/datadrive/data/ESAdocs/federal_register/fr1670.pdf	0	0	0	0	0	0	0	0	2
/datadrive/data/ESAdocs/federal_register/fr1673.pdf	5	0	1	1	13	0	0	20	14
/datadrive/data/ESAdocs/federal_register/fr1674.pdf	0	0	0	0	2	0	0	2	3
/datadrive/data/ESAdocs/federal_register/fr1675.pdf	0	0	0	0	7	0	0	7	18
/datadrive/data/ESAdocs/federal_register/fr1676.pdf	0	0	0	0	0	0	0	0	3
/datadrive/data/ESAdocs/federal_register/fr1677.pdf	0	0	1	1	4	0	0	6	4
/datadrive/data/ESAdocs/federal_register/fr1678.pdf	0	0	0	3	2	1	0	6	5
/datadrive/data/ESAdocs/federal_register/fr1679.pdf	1	0	0	0	3	3	4	11	5
/datadrive/data/ESAdocs/federal_register/fr1680.pdf	0	0	0	0	0	0	0	0	2
/datadrive/data/ESAdocs/federal_register/fr1683.pdf	0	0	0	0	1	0	0	1	5
/datadrive/data/ESAdocs/federal_register/fr1684.pdf	0	0	0	0	0	0	0	0	4
/datadrive/data/ESAdocs/federal_register/fr1687.pdf	0	0	0	0	2	0	1	3	5
/datadrive/data/ESAdocs/federal_register/fr1688.pdf	1	0	1	2	1	0	0	5	4
/datadrive/data/ESAdocs/federal_register/fr1689.pdf	0	0	0	0	1	0	0	1	2
/datadrive/data/ESAdocs/federal_register/fr1693.pdf	0	0	0	0	1	0	0	1	2
/datadrive/data/ESAdocs/federal_register/fr1694.pdf	0	0	0	0	3	0	0	3	4
/datadrive/data/ESAdocs/federal_register/fr1699.pdf	0	0	0	0	3	1	1	5	4
/datadrive/data/ESAdocs/federal_register/fr169.pdf	0	0	0	0	1	0	0	1	3
/datadrive/data/ESAdocs/federal_register/fr1700.pdf	0	0	0	0	0	0	0	0	2
/datadrive/data/ESAdocs/federal_register/fr1701.pdf	1	0	0	0	2	0	0	3	4
/datadrive/data/ESAdocs/federal_register/fr1705.pdf	1	0	1	0	6	0	1	9	6
/datadrive/data/ESAdocs/federal_register/fr1706.pdf	0	0	0	0	7	0	2	9	8
/datadrive/data/ESAdocs/federal_register/fr1708.pdf	0	0	0	0	3	0	0	3	4
/datadrive/data/ESAdocs/federal_register/fr170.pdf	0	0	0	0	2	0	1	3	4
/datadrive/data/ESAdocs/federal_register/fr1712.pdf	0	0	0	0	6	0	0	6	7
/datadrive/data/ESAdocs/federal_register/fr1715.pdf	0	0	0	0	3	0	0	3	4
/datadrive/data/ESAdocs/federal_register/fr1716.pdf	0	0	0	0	4	0	0	4	6
/datadrive/data/ESAdocs/federal_register/fr1717.pdf	0	0	0	0	3	0	0	3	4
/datadrive/data/ESAdocs/federal_register/fr1718.pdf	1	0	0	0	53	0	0	54	82
/datadrive/data/ESAdocs/federal_register/fr1719.pdf	0	0	0	0	3	0	0	3	5
/datadrive/data/ESAdocs/federal_register/fr171.pdf	0	0	0	0	0	0	0	0	3
/datadrive/data/ESAdocs/federal_register/fr1722.pdf	0	0	0	0	4	0	2	6	5
/datadrive/data/ESAdocs/federal_register/fr1723.pdf	0	0	0	0	4	1	2	7	4
/datadrive/data/ESAdocs/federal_register/fr1724.pdf	0	0	0	0	2	1	1	4	5
/datadrive/data/ESAdocs/federal_register/fr1725.pdf	0	0	0	0	3	0	0	3	5
/datadrive/data/ESAdocs/federal_register/fr1728.pdf	0	0	1	0	4	0	0	5	4
/datadrive/data/ESAdocs/federal_register/fr1729.pdf	6	1	0	3	10	0	0	20	10
/datadrive/data/ESAdocs/federal_register/fr1730.pdf	0	0	0	0	9	0	0	9	34
/datadrive/data/ESAdocs/federal_register/fr1731.pdf	0	0	0	0	4	0	3	7	4
/datadrive/data/ESAdocs/federal_register/fr1734.pdf	0	0	0	0	2	0	0	2	3
/datadrive/data/ESAdocs/federal_register/fr1736.pdf	0	3	2	0	5	0	0	10	5
/datadrive/data/ESAdocs/federal_register/fr1737.pdf	0	0	0	0	1	1	0	2	4
/datadrive/data/ESAdocs/federal_register/fr1738.pdf	0	0	0	0	6	0	0	6	7
/datadrive/data/ESAdocs/federal_register/fr1739.pdf	1	0	0	0	1	0	0	2	2
/datadrive/data/ESAdocs/federal_register/fr173.pdf	0	0	0	0	1	0	1	2	4
/datadrive/data/ESAdocs/federal_register/fr1741.pdf	0	0	0	0	1	0	0	1	4
/datadrive/data/ESAdocs/federal_register/fr1742.pdf	0	0	1	0	3	0	0	4	3
/datadrive/data/ESAdocs/federal_register/fr1743.pdf	0	0	0	2	6	3	4	15	6
/datadrive/data/ESAdocs/federal_register/fr1746.pdf	0	0	0	0	1	0	0	1	3
/datadrive/data/ESAdocs/federal_register/fr1748.pdf	0	0	0	0	4	0	1	5	7
/datadrive/data/ESAdocs/federal_register/fr174.pdf	0	0	0	0	1	0	1	2	2
/datadrive/data/ESAdocs/federal_register/fr1755.pdf	0	0	0	0	1	0	0	1	4
/datadrive/data/ESAdocs/federal_register/fr1756.pdf	0	2	3	1	7	0	0	13	7
/datadrive/data/ESAdocs/federal_register/fr1757.pdf	0	0	1	1	4	0	1	7	7
/datadrive/data/ESAdocs/federal_register/fr1758.pdf	0	0	0	0	0	0	0	0	2
/datadrive/data/ESAdocs/federal_register/fr1759.pdf	0	0	1	0	3	0	0	4	5
/datadrive/data/ESAdocs/federal_register/fr1760.pdf	0	0	2	5	8	0	0	15	10
/datadrive/data/ESAdocs/federal_register/fr1763.pdf	0	0	8	13	15	0	0	36	17
/datadrive/data/ESAdocs/federal_register/fr1765.pdf	0	0	0	0	0	0	0	0	5
/datadrive/data/ESAdocs/federal_register/fr1766.pdf	0	0	0	0	3	0	0	3	5
/datadrive/data/ESAdocs/federal_register/fr1767.pdf	0	0	0	0	4	2	0	6	5
/datadrive/data/ESAdocs/federal_register/fr1769.pdf	1	0	1	1	4	0	0	7	4
/datadrive/data/ESAdocs/federal_register/fr1770.pdf	4	7	0	0	5	0	0	16	7
/datadrive/data/ESAdocs/federal_register/fr1775.pdf	0	0	0	0	1	0	0	1	4
/datadrive/data/ESAdocs/federal_register/fr1776.pdf	3	2	0	3	4	0	0	12	5
/datadrive/data/ESAdocs/federal_register/fr1777.pdf	0	0	0	0	3	0	0	3	5
/datadrive/data/ESAdocs/federal_register/fr1778.pdf	0	0	0	0	2	0	2	4	4
/datadrive/data/ESAdocs/federal_register/fr1780.pdf	0	0	0	0	4	0	4	8	6
/datadrive/data/ESAdocs/federal_register/fr1781.pdf	0	0	0	0	4	0	0	4	7
/datadrive/data/ESAdocs/federal_register/fr1784.pdf	0	0	0	0	1	0	1	2	2
/datadrive/data/ESAdocs/federal_register/fr1785.pdf	1	0	1	0	1	0	0	3	3
/datadrive/data/ESAdocs/federal_register/fr1787.pdf	0	0	0	0	5	1	0	6	6
/datadrive/data/ESAdocs/federal_register/fr1789.pdf	1	0	0	1	4	0	0	6	4
/datadrive/data/ESAdocs/federal_register/fr178.pdf	0	0	0	0	3	1	1	5	6
/datadrive/data/ESAdocs/federal_register/fr1790.pdf	0	0	0	0	4	0	0	4	5
/datadrive/data/ESAdocs/federal_register/fr1791.pdf	0	0	0	0	10	0	0	10	38
/datadrive/data/ESAdocs/federal_register/fr1792.pdf	0	0	0	0	0	0	0	0	1
/datadrive/data/ESAdocs/federal_register/fr1793.pdf	0	0	0	0	3	0	0	3	4
/datadrive/data/ESAdocs/federal_register/fr1794.pdf	0	0	0	0	0	0	0	0	2
/datadrive/data/ESAdocs/federal_register/fr1795.pdf	0	0	0	4	4	0	0	8	4
/datadrive/data/ESAdocs/federal_register/fr1799.pdf	0	0	0	0	3	0	2	5	6
/datadrive/data/ESAdocs/federal_register/fr179.pdf	0	0	0	0	3	0	0	3	5
/datadrive/data/ESAdocs/federal_register/fr1800.pdf	0	0	1	0	5	0	0	6	5
/datadrive/data/ESAdocs/federal_register/fr1801.pdf	0	0	0	2	3	0	0	5	4
/datadrive/data/ESAdocs/federal_register/fr1802.pdf	0	0	0	0	1	0	0	1	2
/datadrive/data/ESAdocs/federal_register/fr1804.pdf	1	0	0	0	5	0	0	6	8
/datadrive/data/ESAdocs/federal_register/fr1806.pdf	0	0	0	0	0	0	0	0	4
/datadrive/data/ESAdocs/federal_register/fr180.pdf	0	0	0	0	2	0	0	2	4
/datadrive/data/ESAdocs/federal_register/fr1810.pdf	0	0	0	0	0	0	0	0	4
/datadrive/data/ESAdocs/federal_register/fr1811.pdf	0	0	0	0	0	0	0	0	3
/datadrive/data/ESAdocs/federal_register/fr1812.pdf	0	0	0	0	0	0	0	0	5
/datadrive/data/ESAdocs/federal_register/fr1814.pdf	0	0	0	0	0	0	0	0	5
/datadrive/data/ESAdocs/federal_register/fr1833.pdf	0	0	0	0	0	0	0	0	3
/datadrive/data/ESAdocs/federal_register/fr1839.pdf	0	0	0	0	0	0	0	0	4
/datadrive/data/ESAdocs/federal_register/fr1847.pdf	0	0	0	0	0	0	0	0	7
/datadrive/data/ESAdocs/federal_register/fr1851.pdf	0	0	0	0	0	0	0	0	5
/datadrive/data/ESAdocs/federal_register/fr1853.pdf	0	0	0	0	0	0	0	0	6
/datadrive/data/ESAdocs/federal_register/fr186.pdf	2	0	0	0	8	0	0	10	9
/datadrive/data/ESAdocs/federal_register/fr1873.pdf	0	0	0	0	0	0	0	0	5
/datadrive/data/ESAdocs/federal_register/fr1876.pdf	0	0	0	0	0	0	0	0	7
/datadrive/data/ESAdocs/federal_register/fr1878.pdf	0	0	0	0	3	0	0	3	4
/datadrive/data/ESAdocs/federal_register/fr1886.pdf	0	0	0	0	0	0	0	0	6
/datadrive/data/ESAdocs/federal_register/fr1892.pdf	0	0	0	0	0	0	0	0	4
/datadrive/data/ESAdocs/federal_register/fr18.pdf	0	0	0	0	0	0	0	0	1
/datadrive/data/ESAdocs/federal_register/fr1902.pdf	0	0	0	0	1	0	0	1	3
/datadrive/data/ESAdocs/federal_register/fr1905.pdf	3	0	0	0	15	0	0	18	17
/datadrive/data/ESAdocs/federal_register/fr1909.pdf	0	0	0	1	1	0	0	2	3
/datadrive/data/ESAdocs/federal_register/fr190.pdf	0	0	0	0	1	0	0	1	2
/datadrive/data/ESAdocs/federal_register/fr1914.pdf	0	0	2	0	4	0	0	6	5
/datadrive/data/ESAdocs/federal_register/fr1915.pdf	0	0	0	0	2	0	0	2	5
/datadrive/data/ESAdocs/federal_register/fr1916.pdf	0	0	0	1	4	0	0	5	5
/datadrive/data/ESAdocs/federal_register/fr1917.pdf	0	0	0	0	2	0	0	2	4
/datadrive/data/ESAdocs/federal_register/fr1919.pdf	0	0	0	0	8	0	0	8	8
/datadrive/data/ESAdocs/federal_register/fr1921.pdf	0	3	4	2	9	0	0	18	10
/datadrive/data/ESAdocs/federal_register/fr1922.pdf	0	0	1	1	4	0	1	7	6
/datadrive/data/ESAdocs/federal_register/fr1923.pdf	0	4	8	3	14	0	0	29	15
/datadrive/data/ESAdocs/federal_register/fr1927.pdf	2	0	0	0	3	0	0	5	5
/datadrive/data/ESAdocs/federal_register/fr1928.pdf	0	0	0	3	5	0	0	8	5
/datadrive/data/ESAdocs/federal_register/fr1929.pdf	0	0	0	0	3	0	0	3	5
/datadrive/data/ESAdocs/federal_register/fr1930.pdf	0	0	1	0	1	0	0	2	2
/datadrive/data/ESAdocs/federal_register/fr1931.pdf	0	0	0	0	3	0	0	3	4
/datadrive/data/ESAdocs/federal_register/fr1932.pdf	0	0	1	1	5	0	0	7	6
/datadrive/data/ESAdocs/federal_register/fr1933.pdf	0	0	1	0	2	0	0	3	4
/datadrive/data/ESAdocs/federal_register/fr1935.pdf	0	0	0	0	4	1	2	7	6
/datadrive/data/ESAdocs/federal_register/fr1937.pdf	1	0	2	1	4	0	0	8	4
/datadrive/data/ESAdocs/federal_register/fr1938.pdf	0	0	0	0	7	1	3	11	10
/datadrive/data/ESAdocs/federal_register/fr193.pdf	0	0	0	0	2	0	0	2	2
/datadrive/data/ESAdocs/federal_register/fr1940.pdf	0	0	0	0	1	0	0	1	4
/datadrive/data/ESAdocs/federal_register/fr1942.pdf	0	0	0	0	0	0	0	0	1
/datadrive/data/ESAdocs/federal_register/fr1943.pdf	0	0	0	0	3	0	1	4	4
/datadrive/data/ESAdocs/federal_register/fr1944.pdf	0	0	0	1	1	0	0	2	4
/datadrive/data/ESAdocs/federal_register/fr1947.pdf	0	0	0	0	7	0	3	10	8
/datadrive/data/ESAdocs/federal_register/fr1948.pdf	0	0	0	0	9	0	4	13	11
/datadrive/data/ESAdocs/federal_register/fr1949.pdf	0	0	0	1	4	1	0	6	8
/datadrive/data/ESAdocs/federal_register/fr1952.pdf	0	0	7	12	13	0	0	32	17
/datadrive/data/ESAdocs/federal_register/fr1953.pdf	1	1	11	6	22	0	0	41	24
/datadrive/data/ESAdocs/federal_register/fr1954.pdf	9	1	1	0	8	0	0	19	10
/datadrive/data/ESAdocs/federal_register/fr1955.pdf	0	0	0	0	8	0	0	8	12
/datadrive/data/ESAdocs/federal_register/fr1960.pdf	0	0	0	0	0	0	0	0	1
/datadrive/data/ESAdocs/federal_register/fr1961.pdf	4	0	1	4	7	0	0	16	8
/datadrive/data/ESAdocs/federal_register/fr1963.pdf	1	0	0	0	3	0	2	6	6
/datadrive/data/ESAdocs/federal_register/fr1964.pdf	2	0	1	0	4	0	1	8	5
/datadrive/data/ESAdocs/federal_register/fr1965.pdf	0	0	0	0	3	1	1	5	4
/datadrive/data/ESAdocs/federal_register/fr1966.pdf	0	0	0	0	1	0	0	1	1
/datadrive/data/ESAdocs/federal_register/fr1967.pdf	0	0	1	0	8	0	1	10	8
/datadrive/data/ESAdocs/federal_register/fr1968.pdf	0	0	1	0	6	2	4	13	10
/datadrive/data/ESAdocs/federal_register/fr1972.pdf	0	0	0	0	0	0	0	0	2
/datadrive/data/ESAdocs/federal_register/fr1973.pdf	0	1	0	0	24	0	0	25	33
/datadrive/data/ESAdocs/federal_register/fr1975.pdf	0	0	0	0	9	0	0	9	9
/datadrive/data/ESAdocs/federal_register/fr1976.pdf	1	0	1	1	2	0	0	5	4
/datadrive/data/ESAdocs/federal_register/fr1977.pdf	0	0	0	0	0	0	0	0	5
/datadrive/data/ESAdocs/federal_register/fr1978.pdf	0	0	0	0	0	0	0	0	5
/datadrive/data/ESAdocs/federal_register/fr1979.pdf	0	0	0	0	3	0	0	3	5
/datadrive/data/ESAdocs/federal_register/fr1980.pdf	4	0	0	3	9	0	0	16	10
/datadrive/data/ESAdocs/federal_register/fr1982.pdf	0	0	0	0	3	0	0	3	6
/datadrive/data/ESAdocs/federal_register/fr1983.pdf	0	0	0	0	2	0	0	2	2
/datadrive/data/ESAdocs/federal_register/fr1984.pdf	4	1	1	0	7	0	0	13	8
/datadrive/data/ESAdocs/federal_register/fr1991.pdf	3	0	2	1	8	2	0	16	9
/datadrive/data/ESAdocs/federal_register/fr1993.pdf	1	0	0	0	4	0	1	6	8
/datadrive/data/ESAdocs/federal_register/fr1995.pdf	0	0	0	0	0	0	0	0	2
/datadrive/data/ESAdocs/federal_register/fr2006.pdf	1	1	1	3	5	0	0	11	6
/datadrive/data/ESAdocs/federal_register/fr2007.pdf	0	0	0	1	6	0	0	7	7
/datadrive/data/ESAdocs/federal_register/fr2008.pdf	0	0	0	0	22	4	4	30	43
/datadrive/data/ESAdocs/federal_register/fr2009.pdf	2	0	0	1	6	0	0	9	7
/datadrive/data/ESAdocs/federal_register/fr2012.pdf	0	0	0	0	6	0	0	6	7
/datadrive/data/ESAdocs/federal_register/fr201.pdf	1	0	0	0	3	1	2	7	3
/datadrive/data/ESAdocs/federal_register/fr2025.pdf	0	0	0	0	0	0	0	0	2
/datadrive/data/ESAdocs/federal_register/fr2027.pdf	2	0	1	1	5	0	0	9	5
/datadrive/data/ESAdocs/federal_register/fr2028.pdf	2	0	0	0	2	0	0	4	3
/datadrive/data/ESAdocs/federal_register/fr2029.pdf	3	0	1	0	2	0	0	6	5
/datadrive/data/ESAdocs/federal_register/fr2030.pdf	0	0	0	0	0	0	0	0	2
/datadrive/data/ESAdocs/federal_register/fr2031.pdf	0	0	0	0	1	0	0	1	2
/datadrive/data/ESAdocs/federal_register/fr2032.pdf	0	0	0	0	0	0	0	0	5
/datadrive/data/ESAdocs/federal_register/fr2033.pdf	1	0	0	0	10	0	0	11	11
/datadrive/data/ESAdocs/federal_register/fr2035.pdf	0	0	0	0	1	0	0	1	4
/datadrive/data/ESAdocs/federal_register/fr2036.pdf	0	0	0	0	3	1	3	7	5
/datadrive/data/ESAdocs/federal_register/fr2038.pdf	0	0	0	0	3	0	0	3	6
/datadrive/data/ESAdocs/federal_register/fr2039.pdf	0	0	1	0	6	0	0	7	7
/datadrive/data/ESAdocs/federal_register/fr2040.pdf	4	7	3	1	7	0	0	22	8
/datadrive/data/ESAdocs/federal_register/fr2041.pdf	5	1	2	4	7	0	0	19	8
/datadrive/data/ESAdocs/federal_register/fr2042.pdf	0	0	0	0	3	0	0	3	5
/datadrive/data/ESAdocs/federal_register/fr2043.pdf	1	0	0	0	6	1	0	8	8
/datadrive/data/ESAdocs/federal_register/fr2049.pdf	0	0	2	0	3	0	0	5	3
/datadrive/data/ESAdocs/federal_register/fr204.pdf	0	0	0	0	2	0	0	2	3
/datadrive/data/ESAdocs/federal_register/fr2050.pdf	0	0	0	1	2	0	0	3	4
/datadrive/data/ESAdocs/federal_register/fr2051.pdf	0	0	9	5	13	0	0	27	17
/datadrive/data/ESAdocs/federal_register/fr2053.pdf	0	0	0	0	5	0	0	5	6
/datadrive/data/ESAdocs/federal_register/fr2054.pdf	1	0	0	0	3	0	0	4	3
/datadrive/data/ESAdocs/federal_register/fr2056.pdf	0	0	0	0	3	0	0	3	5
/datadrive/data/ESAdocs/federal_register/fr2057.pdf	0	0	0	0	0	0	0	0	3
/datadrive/data/ESAdocs/federal_register/fr2058.pdf	0	0	0	0	0	0	0	0	6
/datadrive/data/ESAdocs/federal_register/fr2059.pdf	0	0	0	0	4	1	1	6	6
/datadrive/data/ESAdocs/federal_register/fr2061.pdf	0	0	0	2	3	1	0	6	5
/datadrive/data/ESAdocs/federal_register/fr2062.pdf	0	0	0	0	3	1	1	5	4
/datadrive/data/ESAdocs/federal_register/fr2063.pdf	1	0	0	0	3	2	2	8	5
/datadrive/data/ESAdocs/federal_register/fr2067.pdf	3	0	0	0	6	0	0	9	6
/datadrive/data/ESAdocs/federal_register/fr2073.pdf	0	0	0	0	0	0	0	0	12
/datadrive/data/ESAdocs/federal_register/fr2074.pdf	0	0	0	0	5	0	0	5	5
/datadrive/data/ESAdocs/federal_register/fr2075.pdf	0	0	3	2	3	0	0	8	5
/datadrive/data/ESAdocs/federal_register/fr2078.pdf	0	0	0	0	2	0	0	2	3
/datadrive/data/ESAdocs/federal_register/fr207.pdf	0	0	0	0	2	0	1	3	3
/datadrive/data/ESAdocs/federal_register/fr2084.pdf	1	0	0	0	4	0	0	5	6
/datadrive/data/ESAdocs/federal_register/fr2085.pdf	0	0	0	0	5	0	2	7	6
/datadrive/data/ESAdocs/federal_register/fr208.pdf	0	1	0	0	7	0	0	8	7
/datadrive/data/ESAdocs/federal_register/fr2101.pdf	1	0	0	0	11	0	0	12	17
/datadrive/data/ESAdocs/federal_register/fr2111.pdf	0	0	0	1	2	0	0	3	3
/datadrive/data/ESAdocs/federal_register/fr2117.pdf	0	0	0	0	0	0	0	0	5
/datadrive/data/ESAdocs/federal_register/fr2118.pdf	0	0	1	0	2	0	0	3	4
/datadrive/data/ESAdocs/federal_register/fr2123.pdf	0	0	0	0	2	0	0	2	4
/datadrive/data/ESAdocs/federal_register/fr2128.pdf	0	0	0	0	0	0	0	0	1
/datadrive/data/ESAdocs/federal_register/fr2130.pdf	0	0	0	2	4	0	0	6	6
/datadrive/data/ESAdocs/federal_register/fr2131.pdf	0	0	0	0	3	0	0	3	4
/datadrive/data/ESAdocs/federal_register/fr2132.pdf	0	0	0	1	9	0	0	10	10
/datadrive/data/ESAdocs/federal_register/fr2133.pdf	0	0	0	0	8	0	0	8	10
/datadrive/data/ESAdocs/federal_register/fr2134.pdf	0	0	0	0	1	0	0	1	2
/datadrive/data/ESAdocs/federal_register/fr2136.pdf	0	0	0	0	1	0	0	1	1
/datadrive/data/ESAdocs/federal_register/fr2138.pdf	3	0	1	0	5	0	0	9	6
/datadrive/data/ESAdocs/federal_register/fr213.pdf	0	0	0	0	2	0	0	2	2
/datadrive/data/ESAdocs/federal_register/fr2140.pdf	0	0	0	0	4	0	0	4	5
/datadrive/data/ESAdocs/federal_register/fr2141.pdf	1	0	0	0	2	0	0	3	4
/datadrive/data/ESAdocs/federal_register/fr2143.pdf	0	0	3	3	12	0	0	18	13
/datadrive/data/ESAdocs/federal_register/fr214.pdf	0	0	0	0	3	0	0	3	5
/datadrive/data/ESAdocs/federal_register/fr2150.pdf	4	0	2	0	4	0	0	10	6
/datadrive/data/ESAdocs/federal_register/fr2152.pdf	0	0	0	0	6	1	1	8	7
/datadrive/data/ESAdocs/federal_register/fr2153.pdf	1	1	0	0	4	0	0	6	5
/datadrive/data/ESAdocs/federal_register/fr2164.pdf	0	0	0	0	1	0	0	1	2
/datadrive/data/ESAdocs/federal_register/fr2166.pdf	0	0	0	0	5	0	0	5	6
/datadrive/data/ESAdocs/federal_register/fr2168.pdf	0	0	0	0	5	1	2	8	5
/datadrive/data/ESAdocs/federal_register/fr216.pdf	0	0	0	0	2	0	0	2	4
/datadrive/data/ESAdocs/federal_register/fr2170.pdf	0	0	0	0	0	0	0	0	2
/datadrive/data/ESAdocs/federal_register/fr2171.pdf	0	0	0	2	8	1	0	11	9
/datadrive/data/ESAdocs/federal_register/fr2172.pdf	1	0	0	1	5	0	0	7	6
/datadrive/data/ESAdocs/federal_register/fr2173.pdf	1	2	0	0	5	0	1	9	6
/datadrive/data/ESAdocs/federal_register/fr2177.pdf	0	0	1	0	4	1	1	7	5
/datadrive/data/ESAdocs/federal_register/fr2178.pdf	0	0	0	0	5	0	2	7	6
/datadrive/data/ESAdocs/federal_register/fr2179.pdf	0	0	0	0	1	0	2	3	3
/datadrive/data/ESAdocs/federal_register/fr2180.pdf	2	0	1	0	11	1	1	16	14
/datadrive/data/ESAdocs/federal_register/fr2183.pdf	0	0	0	0	8	0	0	8	9
/datadrive/data/ESAdocs/federal_register/fr2184.pdf	0	0	1	1	9	3	8	22	14
/datadrive/data/ESAdocs/federal_register/fr2185.pdf	1	8	7	10	14	0	0	40	20
/datadrive/data/ESAdocs/federal_register/fr2186.pdf	0	3	3	0	4	0	0	10	5
/datadrive/data/ESAdocs/federal_register/fr2194.pdf	0	0	1	0	2	0	0	3	4
/datadrive/data/ESAdocs/federal_register/fr2198.pdf	0	0	0	0	15	2	0	17	16
/datadrive/data/ESAdocs/federal_register/fr219.pdf	0	0	0	0	1	0	0	1	2
/datadrive/data/ESAdocs/federal_register/fr21.pdf	0	0	0	0	0	0	0	0	8
/datadrive/data/ESAdocs/federal_register/fr2208.pdf	0	0	0	0	1	0	1	2	2
/datadrive/data/ESAdocs/federal_register/fr220.pdf	0	0	0	0	1	0	0	1	4
/datadrive/data/ESAdocs/federal_register/fr2210.pdf	0	0	0	0	3	1	2	6	5
/datadrive/data/ESAdocs/federal_register/fr2212.pdf	0	0	0	0	2	0	0	2	5
/datadrive/data/ESAdocs/federal_register/fr2213.pdf	1	0	1	0	12	0	0	14	12
/datadrive/data/ESAdocs/federal_register/fr2215.pdf	4	0	4	2	9	4	0	23	9
/datadrive/data/ESAdocs/federal_register/fr2216.pdf	0	0	0	0	0	0	0	0	1
/datadrive/data/ESAdocs/federal_register/fr2218.pdf	0	0	0	0	12	2	2	16	20
/datadrive/data/ESAdocs/federal_register/fr221.pdf	0	0	0	0	2	0	0	2	2
/datadrive/data/ESAdocs/federal_register/fr2222.pdf	1	0	0	1	6	0	0	8	9
/datadrive/data/ESAdocs/federal_register/fr2225.pdf	1	0	0	0	1	0	0	2	2
/datadrive/data/ESAdocs/federal_register/fr2226.pdf	1	0	0	0	3	0	0	4	3
/datadrive/data/ESAdocs/federal_register/fr2227.pdf	0	0	0	0	3	2	1	6	3
/datadrive/data/ESAdocs/federal_register/fr2229.pdf	0	0	0	0	6	1	3	10	6
/datadrive/data/ESAdocs/federal_register/fr2230.pdf	0	0	0	0	4	0	0	4	5
/datadrive/data/ESAdocs/federal_register/fr2235.pdf	0	0	0	0	7	1	3	11	11
/datadrive/data/ESAdocs/federal_register/fr2236.pdf	0	0	1	1	8	0	0	10	11
/datadrive/data/ESAdocs/federal_register/fr2239.pdf	3	0	2	1	4	0	0	10	6
/datadrive/data/ESAdocs/federal_register/fr223.pdf	1	0	0	2	2	0	0	5	4
/datadrive/data/ESAdocs/federal_register/fr2244.pdf	0	0	0	0	16	0	0	16	24
/datadrive/data/ESAdocs/federal_register/fr2245.pdf	0	0	1	0	7	2	3	13	11
/datadrive/data/ESAdocs/federal_register/fr2247.pdf	0	0	0	0	3	0	0	3	7
/datadrive/data/ESAdocs/federal_register/fr2248.pdf	0	0	0	0	5	1	0	6	8
/datadrive/data/ESAdocs/federal_register/fr224.pdf	0	0	1	0	4	0	0	5	8
/datadrive/data/ESAdocs/federal_register/fr2250.pdf	0	0	1	1	3	0	0	5	5
/datadrive/data/ESAdocs/federal_register/fr2253.pdf	0	0	1	0	14	0	0	15	16
/datadrive/data/ESAdocs/federal_register/fr2254.pdf	0	0	0	0	2	0	0	2	2
/datadrive/data/ESAdocs/federal_register/fr2255.pdf	0	0	0	0	9	0	1	10	13
/datadrive/data/ESAdocs/federal_register/fr225.pdf	1	0	1	0	3	0	0	5	3
/datadrive/data/ESAdocs/federal_register/fr2261.pdf	0	4	1	0	5	0	0	10	7
/datadrive/data/ESAdocs/federal_register/fr2262.pdf	1	0	0	2	6	1	0	10	8
/datadrive/data/ESAdocs/federal_register/fr2268.pdf	0	0	0	0	2	0	0	2	2
/datadrive/data/ESAdocs/federal_register/fr2271.pdf	1	0	1	1	4	3	0	10	6
/datadrive/data/ESAdocs/federal_register/fr2275.pdf	1	0	0	0	4	1	4	10	5
/datadrive/data/ESAdocs/federal_register/fr2276.pdf	0	0	0	0	0	0	0	0	10
/datadrive/data/ESAdocs/federal_register/fr2277.pdf	0	0	1	0	4	0	0	5	4
/datadrive/data/ESAdocs/federal_register/fr2278.pdf	0	0	0	0	6	0	2	8	6
/datadrive/data/ESAdocs/federal_register/fr2286.pdf	0	0	0	0	6	0	0	6	7
/datadrive/data/ESAdocs/federal_register/fr2287.pdf	0	0	5	3	7	0	0	15	8
/datadrive/data/ESAdocs/federal_register/fr2288.pdf	0	0	0	0	0	0	0	0	2
/datadrive/data/ESAdocs/federal_register/fr228.pdf	0	0	0	0	3	0	0	3	4
/datadrive/data/ESAdocs/federal_register/fr2290.pdf	0	0	0	0	3	0	0	3	6
/datadrive/data/ESAdocs/federal_register/fr2295.pdf	0	0	0	0	3	2	1	6	4
/datadrive/data/ESAdocs/federal_register/fr2297.pdf	0	0	0	0	8	0	0	8	11
/datadrive/data/ESAdocs/federal_register/fr2298.pdf	0	0	0	0	6	2	2	10	6
/datadrive/data/ESAdocs/federal_register/fr2303.pdf	0	0	0	0	1	0	0	1	5
/datadrive/data/ESAdocs/federal_register/fr2305.pdf	0	0	0	0	1	0	0	1	3
/datadrive/data/ESAdocs/federal_register/fr2311.pdf	0	0	0	0	6	0	3	9	8
/datadrive/data/ESAdocs/federal_register/fr2316.pdf	0	0	0	0	1	0	0	1	2
/datadrive/data/ESAdocs/federal_register/fr231.pdf	0	0	0	0	9	0	0	9	12
/datadrive/data/ESAdocs/federal_register/fr2323.pdf	0	0	0	0	5	1	2	8	7
/datadrive/data/ESAdocs/federal_register/fr2325.pdf	0	0	0	0	3	1	0	4	5
/datadrive/data/ESAdocs/federal_register/fr2326.pdf	0	0	0	0	1	0	0	1	3
/datadrive/data/ESAdocs/federal_register/fr2327.pdf	0	0	0	0	9	0	4	13	9
/datadrive/data/ESAdocs/federal_register/fr232.pdf	0	0	1	0	3	0	0	4	5
/datadrive/data/ESAdocs/federal_register/fr2330.pdf	0	0	0	0	3	0	0	3	3
/datadrive/data/ESAdocs/federal_register/fr2332.pdf	0	0	0	0	10	0	0	10	12
/datadrive/data/ESAdocs/federal_register/fr2336.pdf	1	0	1	1	4	0	0	7	4
/datadrive/data/ESAdocs/federal_register/fr2337.pdf	1	0	0	0	2	0	0	3	2
/datadrive/data/ESAdocs/federal_register/fr2338.pdf	0	0	0	0	1	0	0	1	1
/datadrive/data/ESAdocs/federal_register/fr2339.pdf	0	0	0	0	0	0	0	0	2
/datadrive/data/ESAdocs/federal_register/fr2346.pdf	5	0	3	0	20	0	1	29	28
/datadrive/data/ESAdocs/federal_register/fr234.pdf	0	0	0	0	5	0	0	5	8
/datadrive/data/ESAdocs/federal_register/fr2351.pdf	0	0	1	0	9	0	0	10	9
/datadrive/data/ESAdocs/federal_register/fr2352.pdf	0	0	2	0	4	0	0	6	5
/datadrive/data/ESAdocs/federal_register/fr2354.pdf	0	0	3	2	5	1	2	13	8
/datadrive/data/ESAdocs/federal_register/fr2357.pdf	0	0	0	0	4	1	0	5	7
/datadrive/data/ESAdocs/federal_register/fr2358.pdf	3	0	2	4	7	2	0	18	9
/datadrive/data/ESAdocs/federal_register/fr235.pdf	0	0	0	0	3	0	0	3	4
/datadrive/data/ESAdocs/federal_register/fr2360.pdf	0	0	0	0	4	0	0	4	5
/datadrive/data/ESAdocs/federal_register/fr2361.pdf	0	0	0	0	1	0	0	1	3
/datadrive/data/ESAdocs/federal_register/fr2362.pdf	0	0	1	0	3	0	2	6	7
/datadrive/data/ESAdocs/federal_register/fr2363.pdf	1	0	0	1	5	0	0	7	5
/datadrive/data/ESAdocs/federal_register/fr2364.pdf	4	0	2	1	8	0	0	15	9
/datadrive/data/ESAdocs/federal_register/fr2371.pdf	0	0	0	0	2	0	0	2	3
/datadrive/data/ESAdocs/federal_register/fr2377.pdf	0	0	0	0	1	0	0	1	3
/datadrive/data/ESAdocs/federal_register/fr2378.pdf	0	0	0	0	1	0	0	1	2
/datadrive/data/ESAdocs/federal_register/fr237.pdf	0	0	0	0	1	1	0	2	3
/datadrive/data/ESAdocs/federal_register/fr2381.pdf	0	0	0	0	2	0	0	2	4
/datadrive/data/ESAdocs/federal_register/fr2389.pdf	0	0	0	0	10	0	0	10	17
/datadrive/data/ESAdocs/federal_register/fr2390.pdf	7	5	2	1	13	0	0	28	21
/datadrive/data/ESAdocs/federal_register/fr2391.pdf	0	0	0	0	4	0	0	4	5
/datadrive/data/ESAdocs/federal_register/fr2392.pdf	1	0	0	0	4	1	2	8	5
/datadrive/data/ESAdocs/federal_register/fr2398.pdf	0	0	9	1	18	0	0	28	19
/datadrive/data/ESAdocs/federal_register/fr239.pdf	0	0	1	1	1	0	0	3	1
/datadrive/data/ESAdocs/federal_register/fr240.pdf	0	1	1	1	3	0	0	6	4
/datadrive/data/ESAdocs/federal_register/fr2411.pdf	0	0	0	0	1	0	0	1	5
/datadrive/data/ESAdocs/federal_register/fr2413.pdf	0	0	0	0	1	0	0	1	2
/datadrive/data/ESAdocs/federal_register/fr2414.pdf	0	0	0	0	1	0	0	1	2
/datadrive/data/ESAdocs/federal_register/fr2415.pdf	2	0	0	0	3	0	0	5	6
/datadrive/data/ESAdocs/federal_register/fr2416.pdf	3	0	1	1	6	0	0	11	6
/datadrive/data/ESAdocs/federal_register/fr2417.pdf	0	0	0	0	2	0	0	2	2
/datadrive/data/ESAdocs/federal_register/fr2418.pdf	0	0	0	0	6	0	0	6	7
/datadrive/data/ESAdocs/federal_register/fr2419.pdf	0	0	0	0	3	2	1	6	3
/datadrive/data/ESAdocs/federal_register/fr241.pdf	0	0	0	0	2	0	1	3	3
/datadrive/data/ESAdocs/federal_register/fr2420.pdf	0	0	0	0	4	0	0	4	5
/datadrive/data/ESAdocs/federal_register/fr2425.pdf	0	0	0	0	33	0	0	33	47
/datadrive/data/ESAdocs/federal_register/fr2426.pdf	0	0	0	4	7	0	0	11	10
/datadrive/data/ESAdocs/federal_register/fr2428.pdf	0	0	0	0	1	0	1	2	4
/datadrive/data/ESAdocs/federal_register/fr2432.pdf	2	1	1	0	5	0	0	9	5
/datadrive/data/ESAdocs/federal_register/fr2435.pdf	2	0	0	1	3	0	0	6	5
/datadrive/data/ESAdocs/federal_register/fr2439.pdf	0	0	0	0	6	1	0	7	7
/datadrive/data/ESAdocs/federal_register/fr2443.pdf	1	0	0	0	3	0	0	4	4
/datadrive/data/ESAdocs/federal_register/fr2445.pdf	0	0	0	1	5	0	0	6	6
/datadrive/data/ESAdocs/federal_register/fr2446.pdf	2	0	0	0	11	0	2	15	14
/datadrive/data/ESAdocs/federal_register/fr245.pdf	0	0	0	0	3	0	0	3	3
/datadrive/data/ESAdocs/federal_register/fr2461.pdf	0	0	0	0	4	0	0	4	5
/datadrive/data/ESAdocs/federal_register/fr2464.pdf	1	0	0	0	3	2	0	6	5
/datadrive/data/ESAdocs/federal_register/fr2466.pdf	0	0	0	0	1	0	1	2	2
/datadrive/data/ESAdocs/federal_register/fr2468.pdf	0	0	0	0	2	0	0	2	5
/datadrive/data/ESAdocs/federal_register/fr2469.pdf	0	0	1	1	1	0	0	3	2
/datadrive/data/ESAdocs/federal_register/fr246.pdf	0	0	0	0	2	0	0	2	2
/datadrive/data/ESAdocs/federal_register/fr2470.pdf	1	0	0	0	2	0	0	3	2
/datadrive/data/ESAdocs/federal_register/fr2476.pdf	0	0	0	0	9	0	0	9	9
/datadrive/data/ESAdocs/federal_register/fr247.pdf	0	0	1	1	1	0	0	3	2
/datadrive/data/ESAdocs/federal_register/fr2480.pdf	0	0	0	0	1	0	1	2	1
/datadrive/data/ESAdocs/federal_register/fr2484.pdf	4	0	2	1	4	0	0	11	5
/datadrive/data/ESAdocs/federal_register/fr2485.pdf	0	0	0	0	5	0	1	6	7
/datadrive/data/ESAdocs/federal_register/fr2487.pdf	0	0	0	2	3	0	0	5	5
/datadrive/data/ESAdocs/federal_register/fr248.pdf	0	0	0	0	1	0	0	1	3
/datadrive/data/ESAdocs/federal_register/fr2490.pdf	0	0	1	0	3	0	0	4	5
/datadrive/data/ESAdocs/federal_register/fr2491.pdf	0	0	0	1	5	0	0	6	6
/datadrive/data/ESAdocs/federal_register/fr2492.pdf	1	0	0	3	3	0	0	7	5
/datadrive/data/ESAdocs/federal_register/fr249.pdf	0	0	0	0	3	0	0	3	3
/datadrive/data/ESAdocs/federal_register/fr2502.pdf	0	1	0	0	2	0	0	3	3
/datadrive/data/ESAdocs/federal_register/fr2507.pdf	0	0	0	0	1	0	0	1	2
/datadrive/data/ESAdocs/federal_register/fr2508.pdf	0	0	0	0	3	0	1	4	5
/datadrive/data/ESAdocs/federal_register/fr2511.pdf	1	1	0	0	10	0	0	12	23
/datadrive/data/ESAdocs/federal_register/fr2513.pdf	2	0	1	1	7	2	0	13	9
/datadrive/data/ESAdocs/federal_register/fr2514.pdf	0	0	0	0	4	0	0	4	5
/datadrive/data/ESAdocs/federal_register/fr2515.pdf	0	0	0	0	0	0	0	0	2
/datadrive/data/ESAdocs/federal_register/fr2516.pdf	4	0	0	3	7	0	0	14	8
/datadrive/data/ESAdocs/federal_register/fr2517.pdf	0	0	1	0	4	2	1	8	7
/datadrive/data/ESAdocs/federal_register/fr2518.pdf	0	0	0	1	7	1	0	9	13
/datadrive/data/ESAdocs/federal_register/fr2519.pdf	11	5	1	1	19	0	0	37	47
/datadrive/data/ESAdocs/federal_register/fr251.pdf	0	0	0	0	4	0	0	4	5
/datadrive/data/ESAdocs/federal_register/fr2522.pdf	0	0	0	0	9	3	8	20	11
/datadrive/data/ESAdocs/federal_register/fr2524.pdf	0	0	0	0	0	0	0	0	5
/datadrive/data/ESAdocs/federal_register/fr2526.pdf	0	0	0	0	1	0	0	1	3
/datadrive/data/ESAdocs/federal_register/fr252.pdf	0	0	0	0	1	1	0	2	5
/datadrive/data/ESAdocs/federal_register/fr2531.pdf	1	1	11	6	23	0	0	42	26
/datadrive/data/ESAdocs/federal_register/fr2533.pdf	0	0	0	0	0	0	0	0	3
/datadrive/data/ESAdocs/federal_register/fr2534.pdf	1	8	9	11	20	0	0	49	21
/datadrive/data/ESAdocs/federal_register/fr2536.pdf	0	0	0	0	5	1	0	6	5
/datadrive/data/ESAdocs/federal_register/fr2541.pdf	0	0	0	0	2	0	0	2	4
/datadrive/data/ESAdocs/federal_register/fr2545.pdf	1	0	0	0	22	2	4	29	27
/datadrive/data/ESAdocs/federal_register/fr2549.pdf	0	0	0	0	0	0	0	0	6
/datadrive/data/ESAdocs/federal_register/fr2553.pdf	0	0	0	0	0	0	0	0	12
/datadrive/data/ESAdocs/federal_register/fr2561.pdf	0	0	0	0	0	0	0	0	5
/datadrive/data/ESAdocs/federal_register/fr2573.pdf	1	0	0	3	7	2	0	13	7
/datadrive/data/ESAdocs/federal_register/fr2574.pdf	0	0	1	0	6	1	0	8	6
/datadrive/data/ESAdocs/federal_register/fr2577.pdf	0	0	0	0	2	0	0	2	4
/datadrive/data/ESAdocs/federal_register/fr2587.pdf	0	0	0	0	1	0	0	1	2
/datadrive/data/ESAdocs/federal_register/fr2594.pdf	1	1	0	0	2	0	0	4	2
/datadrive/data/ESAdocs/federal_register/fr2595.pdf	0	0	0	0	1	0	0	1	2
/datadrive/data/ESAdocs/federal_register/fr2596.pdf	0	0	0	0	2	0	0	2	2
/datadrive/data/ESAdocs/federal_register/fr2597.pdf	0	0	0	0	2	0	0	2	2
/datadrive/data/ESAdocs/federal_register/fr2602.pdf	0	0	2	2	5	0	0	9	7
/datadrive/data/ESAdocs/federal_register/fr2603.pdf	1	2	3	3	5	0	0	14	6
/datadrive/data/ESAdocs/federal_register/fr2617.pdf	1	0	0	0	1	0	0	2	2
/datadrive/data/ESAdocs/federal_register/fr2622.pdf	1	0	1	0	4	0	0	6	6
/datadrive/data/ESAdocs/federal_register/fr2623.pdf	4	0	2	1	5	3	0	15	5
/datadrive/data/ESAdocs/federal_register/fr2624.pdf	0	0	0	0	3	0	0	3	5
/datadrive/data/ESAdocs/federal_register/fr2625.pdf	0	0	0	0	2	0	2	4	7
/datadrive/data/ESAdocs/federal_register/fr262.pdf	0	0	0	0	1	0	0	1	3
/datadrive/data/ESAdocs/federal_register/fr2631.pdf	0	0	0	0	8	3	4	15	8
/datadrive/data/ESAdocs/federal_register/fr2638.pdf	0	0	0	0	2	0	0	2	3
/datadrive/data/ESAdocs/federal_register/fr2639.pdf	0	0	0	0	1	0	0	1	1
/datadrive/data/ESAdocs/federal_register/fr2642.pdf	0	0	0	0	8	2	3	13	9
/datadrive/data/ESAdocs/federal_register/fr2643.pdf	0	0	0	0	7	1	4	12	9
/datadrive/data/ESAdocs/federal_register/fr2647.pdf	0	1	4	3	7	0	0	15	7
/datadrive/data/ESAdocs/federal_register/fr2648.pdf	2	1	2	1	6	0	0	12	6
/datadrive/data/ESAdocs/federal_register/fr2657.pdf	7	3	3	0	11	0	0	24	11
/datadrive/data/ESAdocs/federal_register/fr2658.pdf	7	4	4	0	10	0	0	25	11
/datadrive/data/ESAdocs/federal_register/fr2659.pdf	4	0	1	0	5	0	0	10	6
/datadrive/data/ESAdocs/federal_register/fr2662.pdf	0	0	0	0	11	0	0	11	13
/datadrive/data/ESAdocs/federal_register/fr2663.pdf	1	0	2	0	16	0	0	19	20
/datadrive/data/ESAdocs/federal_register/fr2664.pdf	1	0	0	0	2	0	0	3	5
/datadrive/data/ESAdocs/federal_register/fr2665.pdf	0	0	0	1	5	0	0	6	5
/datadrive/data/ESAdocs/federal_register/fr2666.pdf	0	0	1	0	11	1	0	13	13
/datadrive/data/ESAdocs/federal_register/fr2668.pdf	0	0	0	0	0	0	0	0	2
/datadrive/data/ESAdocs/federal_register/fr2669.pdf	0	0	0	0	1	0	0	1	2
/datadrive/data/ESAdocs/federal_register/fr2672.pdf	0	0	0	0	1	0	0	1	2
/datadrive/data/ESAdocs/federal_register/fr2676.pdf	1	0	0	0	2	0	0	3	2
/datadrive/data/ESAdocs/federal_register/fr2677.pdf	1	0	0	0	1	0	0	2	1
/datadrive/data/ESAdocs/federal_register/fr2678.pdf	0	0	0	0	13	1	3	17	14
/datadrive/data/ESAdocs/federal_register/fr267.pdf	0	0	0	0	1	0	0	1	3
/datadrive/data/ESAdocs/federal_register/fr2683.pdf	0	0	0	0	1	0	0	1	2
/datadrive/data/ESAdocs/federal_register/fr2684.pdf	0	0	0	0	6	0	0	6	6
/datadrive/data/ESAdocs/federal_register/fr2685.pdf	0	0	1	0	3	0	0	4	4
/datadrive/data/ESAdocs/federal_register/fr2692.pdf	3	0	2	1	15	2	1	24	18
/datadrive/data/ESAdocs/federal_register/fr2695.pdf	0	0	0	0	1	0	0	1	2
/datadrive/data/ESAdocs/federal_register/fr2704.pdf	0	0	0	0	2	0	0	2	2
/datadrive/data/ESAdocs/federal_register/fr2705.pdf	0	0	0	0	12	1	0	13	13
/datadrive/data/ESAdocs/federal_register/fr2707.pdf	0	0	1	1	4	0	0	6	4
/datadrive/data/ESAdocs/federal_register/fr2711.pdf	3	0	4	5	10	0	0	22	11
/datadrive/data/ESAdocs/federal_register/fr2712.pdf	0	0	0	3	6	0	0	9	8
/datadrive/data/ESAdocs/federal_register/fr2713.pdf	0	0	0	0	1	0	0	1	2
/datadrive/data/ESAdocs/federal_register/fr2715.pdf	0	0	0	1	5	0	0	6	6
/datadrive/data/ESAdocs/federal_register/fr271.pdf	0	0	0	0	1	0	0	1	3
/datadrive/data/ESAdocs/federal_register/fr2725.pdf	0	0	0	0	1	0	0	1	2
/datadrive/data/ESAdocs/federal_register/fr2726.pdf	0	0	1	2	4	0	0	7	4
/datadrive/data/ESAdocs/federal_register/fr2727.pdf	0	0	10	2	17	0	0	29	19
/datadrive/data/ESAdocs/federal_register/fr2729.pdf	0	2	0	0	33	0	0	35	47
/datadrive/data/ESAdocs/federal_register/fr2735.pdf	12	3	3	0	16	0	0	34	16
/datadrive/data/ESAdocs/federal_register/fr2736.pdf	2	0	0	0	10	4	2	18	11
/datadrive/data/ESAdocs/federal_register/fr2737.pdf	0	0	0	0	2	0	0	2	4
/datadrive/data/ESAdocs/federal_register/fr2740.pdf	2	2	2	0	10	1	6	23	16
/datadrive/data/ESAdocs/federal_register/fr2741.pdf	0	0	4	3	7	0	0	14	7
/datadrive/data/ESAdocs/federal_register/fr2742.pdf	0	0	0	0	12	0	0	12	40
/datadrive/data/ESAdocs/federal_register/fr2743.pdf	0	0	0	0	4	0	0	4	4
/datadrive/data/ESAdocs/federal_register/fr2746.pdf	3	0	3	2	11	3	0	22	11
/datadrive/data/ESAdocs/federal_register/fr2748.pdf	0	0	0	0	11	1	3	15	16
/datadrive/data/ESAdocs/federal_register/fr2749.pdf	1	5	4	4	11	0	1	26	12
/datadrive/data/ESAdocs/federal_register/fr2750.pdf	0	0	3	2	9	2	1	17	9
/datadrive/data/ESAdocs/federal_register/fr2751.pdf	0	0	0	0	18	0	16	34	24
/datadrive/data/ESAdocs/federal_register/fr2752.pdf	1	0	2	2	5	0	0	10	6
/datadrive/data/ESAdocs/federal_register/fr2753.pdf	0	0	0	0	5	2	2	9	8
/datadrive/data/ESAdocs/federal_register/fr2758.pdf	0	0	0	0	1	0	0	1	3
/datadrive/data/ESAdocs/federal_register/fr2761.pdf	1	0	0	0	2	0	0	3	2
/datadrive/data/ESAdocs/federal_register/fr2764.pdf	1	0	0	0	4	0	0	5	6
/datadrive/data/ESAdocs/federal_register/fr2766.pdf	0	0	0	0	0	0	0	0	2
/datadrive/data/ESAdocs/federal_register/fr2771.pdf	2	0	2	0	5	0	0	9	7
/datadrive/data/ESAdocs/federal_register/fr2772.pdf	0	0	0	0	5	0	0	5	6
/datadrive/data/ESAdocs/federal_register/fr2774.pdf	0	0	0	0	1	0	0	1	2
/datadrive/data/ESAdocs/federal_register/fr2775.pdf	0	0	0	0	1	0	0	1	4
/datadrive/data/ESAdocs/federal_register/fr2777.pdf	0	0	0	0	4	0	0	4	7
/datadrive/data/ESAdocs/federal_register/fr2778.pdf	0	0	0	0	0	0	0	0	2
/datadrive/data/ESAdocs/federal_register/fr2779.pdf	2	0	1	0	14	0	0	17	15
/datadrive/data/ESAdocs/federal_register/fr2780.pdf	0	0	0	0	4	0	0	4	7
/datadrive/data/ESAdocs/federal_register/fr2789.pdf	0	0	0	0	1	0	0	1	2
/datadrive/data/ESAdocs/federal_register/fr278.pdf	0	0	0	0	2	0	0	2	3
/datadrive/data/ESAdocs/federal_register/fr2790.pdf	15	0	6	0	18	0	0	39	23
/datadrive/data/ESAdocs/federal_register/fr2792.pdf	1	0	2	0	17	0	0	20	43
/datadrive/data/ESAdocs/federal_register/fr2793.pdf	0	0	0	0	2	0	0	2	5
/datadrive/data/ESAdocs/federal_register/fr2795.pdf	0	0	0	0	2	0	0	2	3
/datadrive/data/ESAdocs/federal_register/fr27.pdf	0	0	0	0	0	0	0	0	2
/datadrive/data/ESAdocs/federal_register/fr2800.pdf	0	0	0	0	3	0	0	3	3
/datadrive/data/ESAdocs/federal_register/fr2801.pdf	0	0	0	0	2	0	0	2	3
/datadrive/data/ESAdocs/federal_register/fr2807.pdf	7	0	1	0	10	0	0	18	12
/datadrive/data/ESAdocs/federal_register/fr2808.pdf	0	0	0	0	9	0	0	9	16
/datadrive/data/ESAdocs/federal_register/fr2810.pdf	7	0	1	0	5	0	0	13	10
/datadrive/data/ESAdocs/federal_register/fr2814.pdf	0	0	0	0	1	0	0	1	2
/datadrive/data/ESAdocs/federal_register/fr2826.pdf	0	0	0	0	6	0	0	6	7
/datadrive/data/ESAdocs/federal_register/fr2829.pdf	3	0	0	0	22	0	0	25	39
/datadrive/data/ESAdocs/federal_register/fr2831.pdf	1	0	1	0	1	0	0	3	2
/datadrive/data/ESAdocs/federal_register/fr2833.pdf	0	0	0	0	2	0	0	2	2
/datadrive/data/ESAdocs/federal_register/fr2835.pdf	0	0	0	0	6	0	0	6	8
/datadrive/data/ESAdocs/federal_register/fr2839.pdf	0	0	0	0	2	0	0	2	2
/datadrive/data/ESAdocs/federal_register/fr2843.pdf	0	0	0	0	1	0	0	1	2
/datadrive/data/ESAdocs/federal_register/fr2854.pdf	0	0	1	0	4	0	0	5	7
/datadrive/data/ESAdocs/federal_register/fr2855.pdf	6	0	12	0	17	0	0	35	19
/datadrive/data/ESAdocs/federal_register/fr2856.pdf	2	0	0	0	20	0	0	22	20
/datadrive/data/ESAdocs/federal_register/fr2858.pdf	0	0	0	0	5	0	0	5	6
/datadrive/data/ESAdocs/federal_register/fr2859.pdf	6	0	7	0	13	0	0	26	13
/datadrive/data/ESAdocs/federal_register/fr285.pdf	0	0	0	0	1	0	0	1	3
/datadrive/data/ESAdocs/federal_register/fr2860.pdf	0	0	0	0	11	0	0	11	12
/datadrive/data/ESAdocs/federal_register/fr2861.pdf	5	0	4	1	10	0	0	20	11
/datadrive/data/ESAdocs/federal_register/fr2866.pdf	0	0	2	1	7	0	0	10	9
/datadrive/data/ESAdocs/federal_register/fr2870.pdf	0	0	0	0	3	0	0	3	3
/datadrive/data/ESAdocs/federal_register/fr2878.pdf	0	0	0	0	1	0	0	1	1
/datadrive/data/ESAdocs/federal_register/fr287.pdf	0	0	0	0	1	0	0	1	3
/datadrive/data/ESAdocs/federal_register/fr2880.pdf	1	0	1	0	1	0	0	3	2
/datadrive/data/ESAdocs/federal_register/fr2881.pdf	1	0	0	0	2	0	0	3	2
/datadrive/data/ESAdocs/federal_register/fr2882.pdf	0	0	0	0	1	0	0	1	2
/datadrive/data/ESAdocs/federal_register/fr2893.pdf	1	1	11	0	14	0	0	27	16
/datadrive/data/ESAdocs/federal_register/fr2898.pdf	0	0	0	0	1	0	0	1	1
/datadrive/data/ESAdocs/federal_register/fr2899.pdf	0	0	0	0	1	0	0	1	1
/datadrive/data/ESAdocs/federal_register/fr28.pdf	0	0	0	0	3	0	0	3	4
/datadrive/data/ESAdocs/federal_register/fr2900.pdf	0	0	0	0	2	0	0	2	2
/datadrive/data/ESAdocs/federal_register/fr2901.pdf	1	0	0	0	2	0	0	3	2
/datadrive/data/ESAdocs/federal_register/fr2902.pdf	0	0	0	0	2	0	0	2	4
/datadrive/data/ESAdocs/federal_register/fr2903.pdf	0	0	0	0	3	0	0	3	5
/datadrive/data/ESAdocs/federal_register/fr2908.pdf	0	1	0	0	9	0	0	10	10
/datadrive/data/ESAdocs/federal_register/fr2911.pdf	0	0	4	0	18	0	0	22	20
/datadrive/data/ESAdocs/federal_register/fr2912.pdf	0	0	9	0	15	0	0	24	16
/datadrive/data/ESAdocs/federal_register/fr2913.pdf	0	0	0	0	4	0	0	4	5
/datadrive/data/ESAdocs/federal_register/fr2914.pdf	1	0	3	0	7	0	0	11	8
/datadrive/data/ESAdocs/federal_register/fr2915.pdf	0	0	0	0	9	0	0	9	10
/datadrive/data/ESAdocs/federal_register/fr2917.pdf	0	0	0	0	10	0	0	10	11
/datadrive/data/ESAdocs/federal_register/fr2927.pdf	2	0	1	0	7	0	0	10	13
/datadrive/data/ESAdocs/federal_register/fr2930.pdf	0	0	0	0	8	0	0	8	8
/datadrive/data/ESAdocs/federal_register/fr2936.pdf	0	0	0	0	2	0	0	2	2
/datadrive/data/ESAdocs/federal_register/fr2940.pdf	0	1	0	0	16	0	0	17	19
/datadrive/data/ESAdocs/federal_register/fr2942.pdf	0	0	0	0	3	0	0	3	3
/datadrive/data/ESAdocs/federal_register/fr2948.pdf	2	0	2	0	4	0	0	8	5
/datadrive/data/ESAdocs/federal_register/fr2950.pdf	0	0	0	0	0	0	0	0	1
/datadrive/data/ESAdocs/federal_register/fr2951.pdf	2	0	0	0	16	0	0	18	17
/datadrive/data/ESAdocs/federal_register/fr2956.pdf	0	0	0	0	3	0	0	3	5
/datadrive/data/ESAdocs/federal_register/fr2960.pdf	10	0	4	0	19	0	0	33	21
/datadrive/data/ESAdocs/federal_register/fr2961.pdf	0	0	0	0	25	0	0	25	66
/datadrive/data/ESAdocs/federal_register/fr2968.pdf	0	0	0	0	11	0	0	11	12
/datadrive/data/ESAdocs/federal_register/fr2976.pdf	0	0	1	0	2	0	0	3	3
/datadrive/data/ESAdocs/federal_register/fr2980.pdf	0	0	3	0	3	0	0	6	5
/datadrive/data/ESAdocs/federal_register/fr2983.pdf	0	0	0	0	6	0	0	6	7
/datadrive/data/ESAdocs/federal_register/fr2989.pdf	0	0	0	0	9	0	0	9	9
/datadrive/data/ESAdocs/federal_register/fr29.pdf	0	0	0	0	0	0	0	0	1
/datadrive/data/ESAdocs/federal_register/fr2.pdf	0	0	0	0	0	0	0	0	4
/datadrive/data/ESAdocs/federal_register/fr3007.pdf	0	0	0	1	12	0	0	13	15
/datadrive/data/ESAdocs/federal_register/fr3009.pdf	1	0	2	0	18	0	0	21	20
/datadrive/data/ESAdocs/federal_register/fr3010.pdf	0	0	4	0	19	0	0	23	20
/datadrive/data/ESAdocs/federal_register/fr3011.pdf	0	0	9	0	16	0	0	25	17
/datadrive/data/ESAdocs/federal_register/fr3012.pdf	1	0	5	0	7	0	0	13	7
/datadrive/data/ESAdocs/federal_register/fr3013.pdf	1	0	4	0	8	0	0	13	8
/datadrive/data/ESAdocs/federal_register/fr3014.pdf	1	1	12	0	13	0	0	27	17
/datadrive/data/ESAdocs/federal_register/fr3017.pdf	3	0	2	0	14	0	0	19	18
/datadrive/data/ESAdocs/federal_register/fr3018.pdf	1	0	2	0	12	0	0	15	13
/datadrive/data/ESAdocs/federal_register/fr3023.pdf	0	0	0	0	0	0	0	0	2
/datadrive/data/ESAdocs/federal_register/fr3029.pdf	1	0	0	0	2	0	0	3	5
/datadrive/data/ESAdocs/federal_register/fr302.pdf	0	0	0	0	0	0	0	0	3
/datadrive/data/ESAdocs/federal_register/fr3030.pdf	10	0	9	0	25	0	0	44	25
/datadrive/data/ESAdocs/federal_register/fr3031.pdf	0	0	0	0	3	0	0	3	5
/datadrive/data/ESAdocs/federal_register/fr3032.pdf	0	0	0	0	7	0	0	7	12
/datadrive/data/ESAdocs/federal_register/fr3033.pdf	0	0	0	0	3	0	0	3	4
/datadrive/data/ESAdocs/federal_register/fr3034.pdf	4	0	2	0	9	0	0	15	10
/datadrive/data/ESAdocs/federal_register/fr3036.pdf	0	0	0	0	0	0	0	0	1
/datadrive/data/ESAdocs/federal_register/fr3039.pdf	0	0	0	0	13	0	0	13	13
/datadrive/data/ESAdocs/federal_register/fr3042.pdf	0	0	1	0	9	0	0	10	12
/datadrive/data/ESAdocs/federal_register/fr3043.pdf	0	0	0	0	8	0	0	8	10
/datadrive/data/ESAdocs/federal_register/fr3044.pdf	4	0	1	0	11	0	0	16	11
/datadrive/data/ESAdocs/federal_register/fr3045.pdf	4	0	5	0	14	0	0	23	15
/datadrive/data/ESAdocs/federal_register/fr3047.pdf	3	0	2	0	9	0	0	14	10
/datadrive/data/ESAdocs/federal_register/fr3055.pdf	3	0	0	0	9	0	0	12	9
/datadrive/data/ESAdocs/federal_register/fr3057.pdf	7	0	4	0	14	0	0	25	15
/datadrive/data/ESAdocs/federal_register/fr3059.pdf	0	0	0	0	6	0	0	6	7
/datadrive/data/ESAdocs/federal_register/fr3061.pdf	0	0	0	0	1	0	0	1	2
/datadrive/data/ESAdocs/federal_register/fr3062.pdf	0	0	0	0	2	0	0	2	2
/datadrive/data/ESAdocs/federal_register/fr3064.pdf	2	0	0	0	10	0	0	12	10
/datadrive/data/ESAdocs/federal_register/fr3065.pdf	1	0	0	0	11	0	0	12	16
/datadrive/data/ESAdocs/federal_register/fr3067.pdf	0	0	0	0	9	0	0	9	11
/datadrive/data/ESAdocs/federal_register/fr3068.pdf	0	0	0	0	1	0	0	1	2
/datadrive/data/ESAdocs/federal_register/fr306.pdf	0	0	0	0	6	0	0	6	6
/datadrive/data/ESAdocs/federal_register/fr3073.pdf	0	0	4	0	13	0	0	17	14
/datadrive/data/ESAdocs/federal_register/fr3075.pdf	0	0	0	0	3	0	0	3	5
/datadrive/data/ESAdocs/federal_register/fr3078.pdf	0	0	0	0	2	0	0	2	2
/datadrive/data/ESAdocs/federal_register/fr3082.pdf	1	0	0	0	8	0	0	9	9
/datadrive/data/ESAdocs/federal_register/fr3083.pdf	0	0	0	0	7	0	0	7	10
/datadrive/data/ESAdocs/federal_register/fr3084.pdf	0	0	0	0	5	0	0	5	6
/datadrive/data/ESAdocs/federal_register/fr3089.pdf	1	0	0	0	17	0	0	18	17
/datadrive/data/ESAdocs/federal_register/fr3091.pdf	3	0	3	0	9	0	0	15	10
/datadrive/data/ESAdocs/federal_register/fr3092.pdf	0	0	0	0	1	0	0	1	2
/datadrive/data/ESAdocs/federal_register/fr3093.pdf	0	0	0	0	6	0	0	6	7
/datadrive/data/ESAdocs/federal_register/fr3094.pdf	3	0	0	0	4	0	0	7	6
/datadrive/data/ESAdocs/federal_register/fr3099.pdf	2	0	0	0	6	0	0	8	8
/datadrive/data/ESAdocs/federal_register/fr30.pdf	0	0	0	0	1	0	0	1	1
/datadrive/data/ESAdocs/federal_register/fr3100.pdf	9	0	2	0	9	0	0	20	12
/datadrive/data/ESAdocs/federal_register/fr3101.pdf	0	0	0	0	0	0	0	0	2
/datadrive/data/ESAdocs/federal_register/fr3102.pdf	1	0	0	0	2	0	0	3	3
/datadrive/data/ESAdocs/federal_register/fr3106.pdf	0	0	0	0	8	0	0	8	8
/datadrive/data/ESAdocs/federal_register/fr3107.pdf	1	0	1	0	3	0	0	5	6
/datadrive/data/ESAdocs/federal_register/fr3108.pdf	3	0	0	0	12	0	0	15	19
/datadrive/data/ESAdocs/federal_register/fr3109.pdf	2	0	1	0	9	0	0	12	11
/datadrive/data/ESAdocs/federal_register/fr310.pdf	0	0	0	0	3	0	0	3	4
/datadrive/data/ESAdocs/federal_register/fr3112.pdf	4	0	0	0	6	0	0	10	7
/datadrive/data/ESAdocs/federal_register/fr3113.pdf	3	0	0	0	4	0	0	7	5
/datadrive/data/ESAdocs/federal_register/fr3114.pdf	9	0	14	0	18	0	0	41	21
/datadrive/data/ESAdocs/federal_register/fr3116.pdf	3	0	0	0	5	0	0	8	6
/datadrive/data/ESAdocs/federal_register/fr311.pdf	0	0	0	0	2	0	0	2	2
/datadrive/data/ESAdocs/federal_register/fr3120.pdf	0	0	1	0	9	0	0	10	11
/datadrive/data/ESAdocs/federal_register/fr312.pdf	0	0	0	0	0	0	0	0	1
/datadrive/data/ESAdocs/federal_register/fr3133.pdf	0	0	0	0	1	0	0	1	3
/datadrive/data/ESAdocs/federal_register/fr3146.pdf	1	0	0	0	2	0	0	3	2
/datadrive/data/ESAdocs/federal_register/fr314.pdf	0	0	0	0	2	0	1	3	3
/datadrive/data/ESAdocs/federal_register/fr3150.pdf	0	0	1	0	3	0	0	4	5
/datadrive/data/ESAdocs/federal_register/fr3167.pdf	0	0	0	0	7	0	0	7	9
/datadrive/data/ESAdocs/federal_register/fr3168.pdf	0	0	0	0	6	0	0	6	8
/datadrive/data/ESAdocs/federal_register/fr3169.pdf	11	0	8	0	16	0	0	35	18
/datadrive/data/ESAdocs/federal_register/fr3171.pdf	0	0	0	0	7	0	0	7	8
/datadrive/data/ESAdocs/federal_register/fr3175.pdf	8	0	1	0	18	0	0	27	19
/datadrive/data/ESAdocs/federal_register/fr3177.pdf	0	0	1	0	8	0	0	9	10
/datadrive/data/ESAdocs/federal_register/fr3178.pdf	3	0	1	0	6	0	0	10	7
/datadrive/data/ESAdocs/federal_register/fr3179.pdf	2	0	0	0	6	0	0	8	7
/datadrive/data/ESAdocs/federal_register/fr3180.pdf	0	0	0	0	2	0	0	2	3
/datadrive/data/ESAdocs/federal_register/fr3181.pdf	0	0	0	0	3	0	0	3	3
/datadrive/data/ESAdocs/federal_register/fr3183.pdf	7	0	1	0	12	0	0	20	15
/datadrive/data/ESAdocs/federal_register/fr3185.pdf	0	0	0	0	7	0	0	7	8
/datadrive/data/ESAdocs/federal_register/fr3187.pdf	0	0	0	0	1	0	0	1	1
/datadrive/data/ESAdocs/federal_register/fr3188.pdf	2	0	0	0	4	0	0	6	4
/datadrive/data/ESAdocs/federal_register/fr3189.pdf	0	0	0	0	2	0	0	2	5
/datadrive/data/ESAdocs/federal_register/fr318.pdf	0	2	2	0	3	0	0	7	3
/datadrive/data/ESAdocs/federal_register/fr3190.pdf	0	0	0	0	6	0	0	6	8
/datadrive/data/ESAdocs/federal_register/fr3191.pdf	0	0	0	0	9	0	0	9	10
/datadrive/data/ESAdocs/federal_register/fr3192.pdf	1	0	2	0	12	0	0	15	14
/datadrive/data/ESAdocs/federal_register/fr3195.pdf	0	0	0	0	1	0	0	1	1
/datadrive/data/ESAdocs/federal_register/fr319.pdf	0	0	0	0	1	0	0	1	2
/datadrive/data/ESAdocs/federal_register/fr3200.pdf	0	0	0	0	1	0	0	1	3
/datadrive/data/ESAdocs/federal_register/fr3202.pdf	12	0	1	0	17	0	0	30	21
/datadrive/data/ESAdocs/federal_register/fr3204.pdf	6	0	2	0	7	0	0	15	7
/datadrive/data/ESAdocs/federal_register/fr3208.pdf	2	0	3	0	6	0	0	11	6
/datadrive/data/ESAdocs/federal_register/fr3209.pdf	0	0	0	0	8	0	0	8	9
/datadrive/data/ESAdocs/federal_register/fr320.pdf	0	0	0	0	3	0	0	3	4
/datadrive/data/ESAdocs/federal_register/fr3210.pdf	1	0	1	0	13	0	0	15	15
/datadrive/data/ESAdocs/federal_register/fr3211.pdf	0	0	0	0	1	0	0	1	2
/datadrive/data/ESAdocs/federal_register/fr3212.pdf	1	0	2	0	4	0	0	7	6
/datadrive/data/ESAdocs/federal_register/fr3217.pdf	1	0	1	0	5	0	0	7	6
/datadrive/data/ESAdocs/federal_register/fr3224.pdf	1	0	0	0	14	0	0	15	24
/datadrive/data/ESAdocs/federal_register/fr3225.pdf	5	3	3	0	16	0	0	27	17
/datadrive/data/ESAdocs/federal_register/fr3226.pdf	0	0	0	0	5	0	0	5	7
/datadrive/data/ESAdocs/federal_register/fr3227.pdf	0	0	0	0	7	0	0	7	8
/datadrive/data/ESAdocs/federal_register/fr3228.pdf	1	0	1	0	6	0	0	8	6
/datadrive/data/ESAdocs/federal_register/fr322.pdf	0	0	0	0	2	0	1	3	3
/datadrive/data/ESAdocs/federal_register/fr3230.pdf	0	0	0	0	2	0	0	2	2
/datadrive/data/ESAdocs/federal_register/fr3232.pdf	0	0	1	0	6	0	0	7	10
/datadrive/data/ESAdocs/federal_register/fr3233.pdf	1	0	1	0	7	0	0	9	8
/datadrive/data/ESAdocs/federal_register/fr3235.pdf	2	0	8	0	10	0	0	20	11
/datadrive/data/ESAdocs/federal_register/fr3237.pdf	4	0	2	0	7	0	0	13	7
/datadrive/data/ESAdocs/federal_register/fr3238.pdf	2	0	2	0	10	0	0	14	10
/datadrive/data/ESAdocs/federal_register/fr3239.pdf	6	0	0	0	6	0	0	12	6
/datadrive/data/ESAdocs/federal_register/fr3241.pdf	1	0	1	0	5	0	0	7	6
/datadrive/data/ESAdocs/federal_register/fr3252.pdf	1	0	0	0	8	0	0	9	9
/datadrive/data/ESAdocs/federal_register/fr3260.pdf	3	0	0	0	13	0	0	16	14
/datadrive/data/ESAdocs/federal_register/fr3262.pdf	7	0	1	0	7	0	0	15	12
/datadrive/data/ESAdocs/federal_register/fr3264.pdf	6	0	2	0	26	0	0	34	28
/datadrive/data/ESAdocs/federal_register/fr3266.pdf	4	0	0	0	18	0	0	22	18
/datadrive/data/ESAdocs/federal_register/fr3270.pdf	5	0	2	0	14	0	0	21	16
/datadrive/data/ESAdocs/federal_register/fr3271.pdf	0	0	0	0	0	0	0	0	3
/datadrive/data/ESAdocs/federal_register/fr3278.pdf	0	0	0	0	1	0	0	1	2
/datadrive/data/ESAdocs/federal_register/fr3279.pdf	0	0	0	0	17	0	0	17	21
/datadrive/data/ESAdocs/federal_register/fr3285.pdf	2	0	0	0	6	0	0	8	6
/datadrive/data/ESAdocs/federal_register/fr3286.pdf	0	0	0	0	14	0	0	14	17
/datadrive/data/ESAdocs/federal_register/fr3292.pdf	5	0	1	0	9	0	0	15	9
/datadrive/data/ESAdocs/federal_register/fr3295.pdf	0	0	0	0	6	0	0	6	9
/datadrive/data/ESAdocs/federal_register/fr3296.pdf	4	0	0	0	9	0	0	13	11
/datadrive/data/ESAdocs/federal_register/fr3302.pdf	5	0	2	1	15	0	0	23	17
/datadrive/data/ESAdocs/federal_register/fr3303.pdf	7	0	3	0	13	0	0	23	14
/datadrive/data/ESAdocs/federal_register/fr3304.pdf	0	0	0	0	7	0	0	7	7
/datadrive/data/ESAdocs/federal_register/fr330.pdf	0	0	0	0	2	0	0	2	2
/datadrive/data/ESAdocs/federal_register/fr3311.pdf	0	0	0	0	2	0	0	2	2
/datadrive/data/ESAdocs/federal_register/fr3312.pdf	0	0	0	0	6	0	0	6	6
/datadrive/data/ESAdocs/federal_register/fr3314.pdf	0	0	1	0	13	0	0	14	14
/datadrive/data/ESAdocs/federal_register/fr3315.pdf	0	0	0	0	12	0	0	12	13
/datadrive/data/ESAdocs/federal_register/fr3318.pdf	4	0	0	0	16	0	0	20	19
/datadrive/data/ESAdocs/federal_register/fr331.pdf	0	0	0	1	2	0	0	3	3
/datadrive/data/ESAdocs/federal_register/fr3320.pdf	3	0	8	0	18	0	0	29	20
/datadrive/data/ESAdocs/federal_register/fr3322.pdf	1	0	1	0	9	0	0	11	9
/datadrive/data/ESAdocs/federal_register/fr3325.pdf	0	0	2	1	17	0	0	20	20
/datadrive/data/ESAdocs/federal_register/fr3326.pdf	1	0	0	0	13	0	0	14	16
/datadrive/data/ESAdocs/federal_register/fr3328.pdf	1	0	2	1	19	0	0	23	20
/datadrive/data/ESAdocs/federal_register/fr3329.pdf	1	0	0	0	3	0	0	4	5
/datadrive/data/ESAdocs/federal_register/fr332.pdf	0	0	0	0	3	0	0	3	3
/datadrive/data/ESAdocs/federal_register/fr3331.pdf	0	0	0	0	2	0	0	2	2
/datadrive/data/ESAdocs/federal_register/fr3335.pdf	0	0	0	0	9	0	0	9	11
/datadrive/data/ESAdocs/federal_register/fr3337.pdf	1	0	1	0	5	0	0	7	7
/datadrive/data/ESAdocs/federal_register/fr3338.pdf	0	0	0	0	9	0	0	9	10
/datadrive/data/ESAdocs/federal_register/fr3339.pdf	0	0	1	0	4	0	0	5	6
/datadrive/data/ESAdocs/federal_register/fr333.pdf	0	0	0	0	7	0	0	7	7
/datadrive/data/ESAdocs/federal_register/fr3342.pdf	2	0	0	0	2	0	0	4	3
/datadrive/data/ESAdocs/federal_register/fr3343.pdf	1	0	0	0	1	0	0	2	2
/datadrive/data/ESAdocs/federal_register/fr3345.pdf	5	0	1	0	22	0	0	28	29
/datadrive/data/ESAdocs/federal_register/fr3346.pdf	0	0	0	0	2	0	0	2	2
/datadrive/data/ESAdocs/federal_register/fr3349.pdf	0	0	0	0	7	0	0	7	8
/datadrive/data/ESAdocs/federal_register/fr3351.pdf	0	0	1	0	2	0	0	3	5
/datadrive/data/ESAdocs/federal_register/fr3352.pdf	0	0	0	0	1	0	0	1	2
/datadrive/data/ESAdocs/federal_register/fr3354.pdf	3	0	3	0	13	0	0	19	14
/datadrive/data/ESAdocs/federal_register/fr3356.pdf	0	0	0	0	8	0	0	8	10
/datadrive/data/ESAdocs/federal_register/fr3357.pdf	3	0	1	0	7	0	0	11	7
/datadrive/data/ESAdocs/federal_register/fr3359.pdf	1	0	0	0	7	0	0	8	17
/datadrive/data/ESAdocs/federal_register/fr3360.pdf	0	0	0	0	8	0	0	8	13
/datadrive/data/ESAdocs/federal_register/fr3365.pdf	0	0	0	0	2	0	0	2	3
/datadrive/data/ESAdocs/federal_register/fr3366.pdf	0	0	1	0	7	0	0	8	9
/datadrive/data/ESAdocs/federal_register/fr3369.pdf	0	0	0	0	7	0	0	7	7
/datadrive/data/ESAdocs/federal_register/fr3373.pdf	0	0	0	0	4	0	0	4	5
/datadrive/data/ESAdocs/federal_register/fr3380.pdf	0	0	0	0	8	0	0	8	10
/datadrive/data/ESAdocs/federal_register/fr3382.pdf	0	0	0	0	9	0	0	9	14
/datadrive/data/ESAdocs/federal_register/fr3388.pdf	5	0	0	0	15	0	0	20	16
/datadrive/data/ESAdocs/federal_register/fr3394.pdf	0	0	0	0	3	0	0	3	4
/datadrive/data/ESAdocs/federal_register/fr3396.pdf	0	0	0	0	6	0	0	6	7
/datadrive/data/ESAdocs/federal_register/fr3397.pdf	1	0	0	0	2	0	0	3	2
/datadrive/data/ESAdocs/federal_register/fr3398.pdf	7	0	3	0	10	0	0	20	11
/datadrive/data/ESAdocs/federal_register/fr3399.pdf	2	0	0	0	10	0	0	12	11
/datadrive/data/ESAdocs/federal_register/fr339.pdf	0	0	0	0	5	0	0	5	5
/datadrive/data/ESAdocs/federal_register/fr3400.pdf	0	0	0	0	8	0	0	8	13
/datadrive/data/ESAdocs/federal_register/fr3401.pdf	4	3	1	0	9	0	0	17	10
/datadrive/data/ESAdocs/federal_register/fr3403.pdf	0	0	0	0	15	0	0	15	17
/datadrive/data/ESAdocs/federal_register/fr3407.pdf	0	0	0	0	2	0	0	2	2
/datadrive/data/ESAdocs/federal_register/fr3409.pdf	2	0	0	0	9	0	0	11	13
/datadrive/data/ESAdocs/federal_register/fr3410.pdf	0	0	0	0	2	0	0	2	2
/datadrive/data/ESAdocs/federal_register/fr3417.pdf	0	0	0	0	1	0	0	1	1
/datadrive/data/ESAdocs/federal_register/fr341.pdf	0	1	1	0	2	0	0	4	3
/datadrive/data/ESAdocs/federal_register/fr342.pdf	0	0	1	1	2	0	0	4	3
/datadrive/data/ESAdocs/federal_register/fr3434.pdf	0	0	2	0	9	0	0	11	10
/datadrive/data/ESAdocs/federal_register/fr3437.pdf	0	0	0	0	1	0	0	1	5
/datadrive/data/ESAdocs/federal_register/fr3439.pdf	0	0	0	0	8	0	0	8	15
/datadrive/data/ESAdocs/federal_register/fr343.pdf	0	0	0	0	2	0	0	2	2
/datadrive/data/ESAdocs/federal_register/fr3441.pdf	1	0	0	0	10	0	0	11	12
/datadrive/data/ESAdocs/federal_register/fr3442.pdf	0	0	0	0	4	0	0	4	6
/datadrive/data/ESAdocs/federal_register/fr3446.pdf	0	0	4	0	15	0	0	19	18
/datadrive/data/ESAdocs/federal_register/fr3447.pdf	6	0	3	0	13	0	0	22	15
/datadrive/data/ESAdocs/federal_register/fr344.pdf	0	0	0	0	2	0	0	2	2
/datadrive/data/ESAdocs/federal_register/fr3456.pdf	5	0	0	0	22	0	0	27	25
/datadrive/data/ESAdocs/federal_register/fr3457.pdf	2	0	3	0	8	0	0	13	8
/datadrive/data/ESAdocs/federal_register/fr3458.pdf	0	0	0	0	1	0	0	1	3
/datadrive/data/ESAdocs/federal_register/fr3459.pdf	3	0	1	0	12	0	0	16	14
/datadrive/data/ESAdocs/federal_register/fr3460.pdf	1	0	1	0	5	0	0	7	7
/datadrive/data/ESAdocs/federal_register/fr3461.pdf	7	0	1	0	9	0	0	17	10
/datadrive/data/ESAdocs/federal_register/fr3463.pdf	0	2	0	0	11	0	0	13	15
/datadrive/data/ESAdocs/federal_register/fr3464.pdf	0	0	0	0	5	0	0	5	5
/datadrive/data/ESAdocs/federal_register/fr3466.pdf	0	0	0	0	2	0	0	2	2
/datadrive/data/ESAdocs/federal_register/fr3467.pdf	0	0	0	0	2	0	0	2	2
/datadrive/data/ESAdocs/federal_register/fr3469.pdf	0	0	0	0	2	0	0	2	2
/datadrive/data/ESAdocs/federal_register/fr346.pdf	0	0	0	0	0	0	0	0	3
/datadrive/data/ESAdocs/federal_register/fr3470.pdf	1	0	0	0	1	0	0	2	2
/datadrive/data/ESAdocs/federal_register/fr3471.pdf	0	0	0	0	0	0	0	0	1
/datadrive/data/ESAdocs/federal_register/fr3473.pdf	2	1	0	0	15	0	0	18	15
/datadrive/data/ESAdocs/federal_register/fr3475.pdf	0	0	0	0	1	0	0	1	2
/datadrive/data/ESAdocs/federal_register/fr3476.pdf	0	0	0	0	2	0	0	2	2
/datadrive/data/ESAdocs/federal_register/fr3478.pdf	4	0	0	5	7	0	0	16	8
/datadrive/data/ESAdocs/federal_register/fr347.pdf	0	0	2	1	2	0	0	5	3
/datadrive/data/ESAdocs/federal_register/fr3481.pdf	0	0	0	1	9	0	0	10	9
/datadrive/data/ESAdocs/federal_register/fr3482.pdf	2	0	0	0	25	6	1	34	33
/datadrive/data/ESAdocs/federal_register/fr3483.pdf	0	0	0	0	1	0	0	1	1
/datadrive/data/ESAdocs/federal_register/fr3484.pdf	4	2	0	2	6	1	0	15	8
/datadrive/data/ESAdocs/federal_register/fr3485.pdf	0	0	0	0	8	0	0	8	9
/datadrive/data/ESAdocs/federal_register/fr3486.pdf	5	11	1	0	10	0	0	27	11
/datadrive/data/ESAdocs/federal_register/fr3487.pdf	0	0	0	0	3	0	0	3	4
/datadrive/data/ESAdocs/federal_register/fr3488.pdf	3	0	0	1	27	10	10	51	28
/datadrive/data/ESAdocs/federal_register/fr3489.pdf	0	0	0	0	2	1	0	3	2
/datadrive/data/ESAdocs/federal_register/fr348.pdf	0	0	1	1	3	0	0	5	4
/datadrive/data/ESAdocs/federal_register/fr3491.pdf	0	0	0	0	1	0	0	1	2
/datadrive/data/ESAdocs/federal_register/fr3492.pdf	0	0	0	1	2	0	0	3	2
/datadrive/data/ESAdocs/federal_register/fr3493.pdf	0	2	0	3	8	0	0	13	11
/datadrive/data/ESAdocs/federal_register/fr3494.pdf	0	2	0	0	2	0	0	4	2
/datadrive/data/ESAdocs/federal_register/fr3495.pdf	0	0	0	0	2	0	1	3	2
/datadrive/data/ESAdocs/federal_register/fr3496.pdf	0	0	0	0	1	0	0	1	1
/datadrive/data/ESAdocs/federal_register/fr3497.pdf	0	0	0	1	7	3	0	11	10
/datadrive/data/ESAdocs/federal_register/fr3498.pdf	1	1	2	1	13	0	1	19	15
/datadrive/data/ESAdocs/federal_register/fr3499.pdf	0	0	0	0	1	0	0	1	2
/datadrive/data/ESAdocs/federal_register/fr349.pdf	0	0	0	0	2	0	0	2	3
/datadrive/data/ESAdocs/federal_register/fr3501.pdf	5	2	3	1	10	0	0	21	10
/datadrive/data/ESAdocs/federal_register/fr3502.pdf	1	0	2	1	14	0	0	18	16
/datadrive/data/ESAdocs/federal_register/fr3504.pdf	0	0	0	0	1	0	0	1	1
/datadrive/data/ESAdocs/federal_register/fr3505.pdf	1	1	1	0	12	1	4	20	17
/datadrive/data/ESAdocs/federal_register/fr3506.pdf	4	4	1	1	6	0	0	16	7
/datadrive/data/ESAdocs/federal_register/fr3507.pdf	0	0	1	0	3	1	0	5	8
/datadrive/data/ESAdocs/federal_register/fr3508.pdf	2	0	0	0	7	0	0	9	10
/datadrive/data/ESAdocs/federal_register/fr3509.pdf	0	0	0	0	6	0	0	6	7
/datadrive/data/ESAdocs/federal_register/fr350.pdf	0	0	1	0	2	0	0	3	3
/datadrive/data/ESAdocs/federal_register/fr3511.pdf	0	1	0	0	12	0	0	13	15
/datadrive/data/ESAdocs/federal_register/fr3512.pdf	3	0	0	0	4	0	0	7	6
/datadrive/data/ESAdocs/federal_register/fr351.pdf	1	1	1	1	3	0	0	7	3
/datadrive/data/ESAdocs/federal_register/fr3520.pdf	0	0	1	1	8	0	0	10	10
/datadrive/data/ESAdocs/federal_register/fr3521.pdf	1	0	2	0	7	0	0	10	8
/datadrive/data/ESAdocs/federal_register/fr3522.pdf	0	0	1	0	4	0	0	5	7
/datadrive/data/ESAdocs/federal_register/fr3523.pdf	4	0	1	1	6	0	0	12	8
/datadrive/data/ESAdocs/federal_register/fr3524.pdf	2	0	0	1	8	0	0	11	10
/datadrive/data/ESAdocs/federal_register/fr3525.pdf	1	0	1	0	5	2	3	12	7
/datadrive/data/ESAdocs/federal_register/fr3527.pdf	0	0	0	0	1	0	0	1	1
/datadrive/data/ESAdocs/federal_register/fr3528.pdf	0	0	0	1	12	0	0	13	27
/datadrive/data/ESAdocs/federal_register/fr3529.pdf	0	0	0	0	12	0	1	13	21
/datadrive/data/ESAdocs/federal_register/fr352.pdf	1	0	1	0	2	0	0	4	2
/datadrive/data/ESAdocs/federal_register/fr3530.pdf	0	0	0	0	14	2	0	16	23
/datadrive/data/ESAdocs/federal_register/fr3531.pdf	1	0	0	0	6	0	0	7	9
/datadrive/data/ESAdocs/federal_register/fr3532.pdf	0	0	0	0	28	1	0	29	32
/datadrive/data/ESAdocs/federal_register/fr3533.pdf	0	0	0	0	12	0	0	12	18
/datadrive/data/ESAdocs/federal_register/fr3534.pdf	1	0	0	3	7	0	0	11	8
/datadrive/data/ESAdocs/federal_register/fr3536.pdf	0	0	0	0	2	0	0	2	3
/datadrive/data/ESAdocs/federal_register/fr3539.pdf	0	0	0	0	0	0	0	0	2
/datadrive/data/ESAdocs/federal_register/fr353.pdf	0	1	1	1	3	0	0	6	5
/datadrive/data/ESAdocs/federal_register/fr3540.pdf	0	0	0	0	2	0	0	2	3
/datadrive/data/ESAdocs/federal_register/fr3541.pdf	0	0	0	0	3	0	0	3	4
/datadrive/data/ESAdocs/federal_register/fr3542.pdf	1	0	0	0	20	5	5	31	24
/datadrive/data/ESAdocs/federal_register/fr3543.pdf	0	0	0	0	2	0	0	2	2
/datadrive/data/ESAdocs/federal_register/fr3545.pdf	8	0	3	4	10	0	0	25	11
/datadrive/data/ESAdocs/federal_register/fr3546.pdf	1	0	3	0	11	0	0	15	11
/datadrive/data/ESAdocs/federal_register/fr3547.pdf	1	0	5	1	11	0	0	18	12
/datadrive/data/ESAdocs/federal_register/fr3548.pdf	0	0	0	0	1	0	0	1	2
/datadrive/data/ESAdocs/federal_register/fr3551.pdf	0	0	0	0	1	0	0	1	1
/datadrive/data/ESAdocs/federal_register/fr3552.pdf	0	0	0	0	30	0	0	30	36
/datadrive/data/ESAdocs/federal_register/fr3553.pdf	0	0	0	0	1	0	0	1	2
/datadrive/data/ESAdocs/federal_register/fr3555.pdf	0	0	0	1	2	0	0	3	2
/datadrive/data/ESAdocs/federal_register/fr3556.pdf	0	0	0	0	1	1	0	2	1
/datadrive/data/ESAdocs/federal_register/fr3559.pdf	0	0	0	0	8	0	0	8	8
/datadrive/data/ESAdocs/federal_register/fr3561.pdf	0	0	1	0	3	0	0	4	3
/datadrive/data/ESAdocs/federal_register/fr3562.pdf	0	0	1	0	10	4	5	20	13
/datadrive/data/ESAdocs/federal_register/fr3563.pdf	1	0	0	0	6	0	0	7	7
/datadrive/data/ESAdocs/federal_register/fr3566.pdf	0	0	0	0	2	0	0	2	2
/datadrive/data/ESAdocs/federal_register/fr3567.pdf	0	0	1	1	7	0	0	9	10
/datadrive/data/ESAdocs/federal_register/fr3568.pdf	0	0	0	0	4	2	5	11	7
/datadrive/data/ESAdocs/federal_register/fr3569.pdf	0	0	0	0	1	0	0	1	2
/datadrive/data/ESAdocs/federal_register/fr3570.pdf	1	0	0	1	2	0	0	4	3
/datadrive/data/ESAdocs/federal_register/fr3575.pdf	0	0	0	0	20	4	6	30	25
/datadrive/data/ESAdocs/federal_register/fr3577.pdf	0	0	0	0	1	0	0	1	2
/datadrive/data/ESAdocs/federal_register/fr3578.pdf	1	1	3	0	10	0	0	15	11
/datadrive/data/ESAdocs/federal_register/fr357.pdf	0	0	0	0	1	0	0	1	3
/datadrive/data/ESAdocs/federal_register/fr3580.pdf	0	0	0	0	0	0	0	0	1
/datadrive/data/ESAdocs/federal_register/fr3581.pdf	0	0	0	0	2	0	0	2	2
/datadrive/data/ESAdocs/federal_register/fr3584.pdf	0	1	1	0	1	0	0	3	1
/datadrive/data/ESAdocs/federal_register/fr358.pdf	0	0	0	0	2	0	0	2	3
/datadrive/data/ESAdocs/federal_register/fr3590.pdf	0	0	0	0	20	0	0	20	64
/datadrive/data/ESAdocs/federal_register/fr3596.pdf	0	0	0	0	0	0	0	0	12
/datadrive/data/ESAdocs/federal_register/fr3600.pdf	0	0	0	0	1	0	0	1	2
/datadrive/data/ESAdocs/federal_register/fr3604.pdf	2	0	0	0	15	4	2	23	16
/datadrive/data/ESAdocs/federal_register/fr3606.pdf	0	0	0	0	25	0	0	25	27
/datadrive/data/ESAdocs/federal_register/fr360.pdf	0	0	0	0	2	0	0	2	3
/datadrive/data/ESAdocs/federal_register/fr361.pdf	0	0	0	0	3	0	0	3	3
/datadrive/data/ESAdocs/federal_register/fr3621.pdf	3	0	0	0	28	0	0	31	28
/datadrive/data/ESAdocs/federal_register/fr3622.pdf	3	0	0	1	58	10	16	88	61
/datadrive/data/ESAdocs/federal_register/fr3625.pdf	2	0	0	0	8	0	0	10	10
/datadrive/data/ESAdocs/federal_register/fr3626.pdf	0	0	3	0	13	0	1	17	15
/datadrive/data/ESAdocs/federal_register/fr3627.pdf	2	0	0	0	3	0	0	5	3
/datadrive/data/ESAdocs/federal_register/fr362.pdf	0	0	0	0	3	0	0	3	3
/datadrive/data/ESAdocs/federal_register/fr3631.pdf	0	0	0	0	1	0	0	1	2
/datadrive/data/ESAdocs/federal_register/fr3634.pdf	2	0	1	0	6	0	0	9	7
/datadrive/data/ESAdocs/federal_register/fr3636.pdf	0	0	0	0	2	0	0	2	3
/datadrive/data/ESAdocs/federal_register/fr3643.pdf	2	0	0	0	2	0	0	4	9
/datadrive/data/ESAdocs/federal_register/fr366.pdf	0	0	0	0	2	0	0	2	3
/datadrive/data/ESAdocs/federal_register/fr3672.pdf	0	1	19	12	50	0	1	83	79
/datadrive/data/ESAdocs/federal_register/fr3676.pdf	0	0	0	0	0	0	0	0	25
/datadrive/data/ESAdocs/federal_register/fr367.pdf	0	0	0	0	1	0	0	1	1
/datadrive/data/ESAdocs/federal_register/fr3683.pdf	0	0	0	0	1	0	0	1	2
/datadrive/data/ESAdocs/federal_register/fr3684.pdf	0	0	0	0	8	3	4	15	12
/datadrive/data/ESAdocs/federal_register/fr3688.pdf	0	0	0	0	11	1	3	15	15
/datadrive/data/ESAdocs/federal_register/fr3689.pdf	1	0	1	1	5	0	0	8	6
/datadrive/data/ESAdocs/federal_register/fr368.pdf	0	0	0	2	2	0	1	5	3
/datadrive/data/ESAdocs/federal_register/fr3693.pdf	0	0	0	0	2	0	0	2	2
/datadrive/data/ESAdocs/federal_register/fr3696.pdf	0	0	0	0	2	0	0	2	3
/datadrive/data/ESAdocs/federal_register/fr3697.pdf	0	0	0	0	0	0	0	0	1
/datadrive/data/ESAdocs/federal_register/fr3698.pdf	0	0	0	0	0	0	0	0	1
/datadrive/data/ESAdocs/federal_register/fr3701.pdf	3	0	0	0	9	0	0	12	12
/datadrive/data/ESAdocs/federal_register/fr3706.pdf	0	0	0	0	25	0	0	25	41
/datadrive/data/ESAdocs/federal_register/fr3708.pdf	0	0	0	0	9	0	0	9	14
/datadrive/data/ESAdocs/federal_register/fr3709.pdf	4	0	0	0	34	0	0	38	62
/datadrive/data/ESAdocs/federal_register/fr3710.pdf	0	0	0	0	14	0	0	14	15
/datadrive/data/ESAdocs/federal_register/fr3711.pdf	1	0	0	0	11	3	1	16	16
/datadrive/data/ESAdocs/federal_register/fr3712.pdf	1	0	0	0	12	0	0	13	30
/datadrive/data/ESAdocs/federal_register/fr3714.pdf	1	0	0	1	12	0	0	14	13
/datadrive/data/ESAdocs/federal_register/fr3716.pdf	0	0	0	0	0	0	0	0	2
/datadrive/data/ESAdocs/federal_register/fr3717.pdf	1	0	0	0	4	0	0	5	6
/datadrive/data/ESAdocs/federal_register/fr3718.pdf	0	1	1	0	2	0	0	4	2
/datadrive/data/ESAdocs/federal_register/fr3719.pdf	0	0	0	0	1	0	0	1	2
/datadrive/data/ESAdocs/federal_register/fr371.pdf	0	0	0	0	1	0	0	1	3
/datadrive/data/ESAdocs/federal_register/fr3720.pdf	0	0	0	0	1	0	0	1	2
/datadrive/data/ESAdocs/federal_register/fr3721.pdf	0	0	0	0	0	0	0	0	2
/datadrive/data/ESAdocs/federal_register/fr3722.pdf	0	0	0	0	2	0	0	2	2
/datadrive/data/ESAdocs/federal_register/fr3723.pdf	0	0	0	0	2	0	0	2	3
/datadrive/data/ESAdocs/federal_register/fr3724.pdf	0	0	0	0	0	0	0	0	2
/datadrive/data/ESAdocs/federal_register/fr3725.pdf	0	0	0	0	2	0	0	2	2
/datadrive/data/ESAdocs/federal_register/fr3726.pdf	0	0	0	0	1	0	0	1	16
/datadrive/data/ESAdocs/federal_register/fr3728.pdf	0	0	0	0	11	0	0	11	13
/datadrive/data/ESAdocs/federal_register/fr3729.pdf	1	0	3	1	26	2	4	37	50
/datadrive/data/ESAdocs/federal_register/fr3731.pdf	0	0	0	0	1	0	0	1	2
/datadrive/data/ESAdocs/federal_register/fr3734.pdf	0	0	0	3	7	1	0	11	7
/datadrive/data/ESAdocs/federal_register/fr3736.pdf	0	0	0	0	6	0	1	7	8
/datadrive/data/ESAdocs/federal_register/fr3737.pdf	0	0	0	0	3	0	0	3	3
/datadrive/data/ESAdocs/federal_register/fr3739.pdf	0	0	0	0	12	4	1	17	12
/datadrive/data/ESAdocs/federal_register/fr3740.pdf	0	0	0	0	22	0	0	22	41
/datadrive/data/ESAdocs/federal_register/fr3741.pdf	0	0	0	0	6	2	0	8	7
/datadrive/data/ESAdocs/federal_register/fr3742.pdf	0	0	0	0	1	0	1	2	3
/datadrive/data/ESAdocs/federal_register/fr3745.pdf	0	0	0	0	20	2	0	22	32
/datadrive/data/ESAdocs/federal_register/fr3746.pdf	0	0	0	0	2	0	0	2	2
/datadrive/data/ESAdocs/federal_register/fr3747.pdf	0	0	0	0	1	0	0	1	2
/datadrive/data/ESAdocs/federal_register/fr3748.pdf	0	0	0	0	2	0	0	2	4
/datadrive/data/ESAdocs/federal_register/fr3750.pdf	0	0	0	0	2	0	0	2	2
/datadrive/data/ESAdocs/federal_register/fr3751.pdf	0	0	0	0	2	0	0	2	2
/datadrive/data/ESAdocs/federal_register/fr3752.pdf	0	0	0	0	2	0	0	2	2
/datadrive/data/ESAdocs/federal_register/fr3753.pdf	0	0	0	0	2	0	0	2	2
/datadrive/data/ESAdocs/federal_register/fr3754.pdf	0	0	0	0	1	0	0	1	2
/datadrive/data/ESAdocs/federal_register/fr3755.pdf	0	0	0	0	6	0	0	6	7
/datadrive/data/ESAdocs/federal_register/fr3756.pdf	0	0	0	1	20	1	2	24	32
/datadrive/data/ESAdocs/federal_register/fr3760.pdf	0	0	0	0	7	0	1	8	8
/datadrive/data/ESAdocs/federal_register/fr3762.pdf	0	0	2	0	15	0	1	18	25
/datadrive/data/ESAdocs/federal_register/fr3763.pdf	1	0	0	0	16	2	2	21	57
/datadrive/data/ESAdocs/federal_register/fr3771.pdf	0	0	0	0	2	0	0	2	2
/datadrive/data/ESAdocs/federal_register/fr3773.pdf	0	0	0	0	14	0	0	14	15
/datadrive/data/ESAdocs/federal_register/fr3775.pdf	0	4	0	0	34	3	2	43	50
/datadrive/data/ESAdocs/federal_register/fr3778.pdf	1	0	0	0	8	3	1	13	18
/datadrive/data/ESAdocs/federal_register/fr3780.pdf	3	0	2	1	16	1	0	23	16
/datadrive/data/ESAdocs/federal_register/fr3781.pdf	0	0	0	0	1	0	0	1	2
/datadrive/data/ESAdocs/federal_register/fr3784.pdf	0	0	0	0	0	0	0	0	3
/datadrive/data/ESAdocs/federal_register/fr3785.pdf	0	0	0	0	2	0	0	2	2
/datadrive/data/ESAdocs/federal_register/fr3787.pdf	0	0	0	0	4	0	0	4	5
/datadrive/data/ESAdocs/federal_register/fr3789.pdf	0	0	0	0	0	0	0	0	2
/datadrive/data/ESAdocs/federal_register/fr3791.pdf	0	0	0	0	1	0	0	1	3
/datadrive/data/ESAdocs/federal_register/fr3793.pdf	2	0	0	0	9	0	1	12	13
/datadrive/data/ESAdocs/federal_register/fr3794.pdf	0	0	0	0	10	5	6	21	14
/datadrive/data/ESAdocs/federal_register/fr3796.pdf	1	0	0	0	6	0	0	7	8
/datadrive/data/ESAdocs/federal_register/fr3798.pdf	0	0	0	0	2	0	0	2	2
/datadrive/data/ESAdocs/federal_register/fr3799.pdf	0	0	0	0	2	0	0	2	3
/datadrive/data/ESAdocs/federal_register/fr37.pdf	0	0	0	0	0	0	0	0	1
/datadrive/data/ESAdocs/federal_register/fr3800.pdf	0	0	0	0	1	0	0	1	2
/datadrive/data/ESAdocs/federal_register/fr3801.pdf	0	0	0	0	2	0	0	2	3
/datadrive/data/ESAdocs/federal_register/fr3803.pdf	1	0	0	0	6	0	0	7	8
/datadrive/data/ESAdocs/federal_register/fr3804.pdf	1	0	0	0	11	0	0	12	11
/datadrive/data/ESAdocs/federal_register/fr3805.pdf	1	0	0	1	15	8	8	33	18
/datadrive/data/ESAdocs/federal_register/fr3806.pdf	0	0	0	5	7	1	0	13	8
/datadrive/data/ESAdocs/federal_register/fr3808.pdf	6	0	0	5	10	0	0	21	10
/datadrive/data/ESAdocs/federal_register/fr3809.pdf	0	0	0	0	3	0	0	3	3
/datadrive/data/ESAdocs/federal_register/fr3810.pdf	3	0	0	1	10	0	0	14	13
/datadrive/data/ESAdocs/federal_register/fr3811.pdf	6	2	1	2	21	3	3	38	26
/datadrive/data/ESAdocs/federal_register/fr3812.pdf	1	0	0	0	1	0	0	2	2
/datadrive/data/ESAdocs/federal_register/fr3813.pdf	3	1	0	2	13	0	0	19	24
/datadrive/data/ESAdocs/federal_register/fr3814.pdf	3	0	2	1	22	3	0	31	42
/datadrive/data/ESAdocs/federal_register/fr3815.pdf	1	0	4	0	16	1	0	22	34
/datadrive/data/ESAdocs/federal_register/fr3816.pdf	1	0	0	1	2	0	0	4	3
/datadrive/data/ESAdocs/federal_register/fr3817.pdf	6	0	2	6	8	0	0	22	9
/datadrive/data/ESAdocs/federal_register/fr3818.pdf	0	0	0	0	4	4	5	13	7
/datadrive/data/ESAdocs/federal_register/fr3820.pdf	6	0	3	1	12	0	0	22	16
/datadrive/data/ESAdocs/federal_register/fr3821.pdf	0	0	0	0	1	0	0	1	1
/datadrive/data/ESAdocs/federal_register/fr3822.pdf	1	1	1	0	11	0	0	14	12
/datadrive/data/ESAdocs/federal_register/fr3824.pdf	0	0	0	0	1	0	1	2	2
/datadrive/data/ESAdocs/federal_register/fr3825.pdf	2	0	0	0	8	1	5	16	9
/datadrive/data/ESAdocs/federal_register/fr3826.pdf	0	0	0	0	2	0	0	2	2
/datadrive/data/ESAdocs/federal_register/fr3827.pdf	0	0	0	0	2	0	0	2	2
/datadrive/data/ESAdocs/federal_register/fr3830.pdf	0	0	0	0	1	0	0	1	2
/datadrive/data/ESAdocs/federal_register/fr3832.pdf	0	0	0	0	3	0	0	3	3
/datadrive/data/ESAdocs/federal_register/fr3834.pdf	1	0	0	0	2	0	0	3	2
/datadrive/data/ESAdocs/federal_register/fr3835.pdf	1	0	0	1	7	0	0	9	7
/datadrive/data/ESAdocs/federal_register/fr3836.pdf	0	0	0	1	5	0	0	6	7
/datadrive/data/ESAdocs/federal_register/fr3837.pdf	0	0	0	0	11	2	1	14	19
/datadrive/data/ESAdocs/federal_register/fr3839.pdf	0	0	0	0	11	0	1	12	17
/datadrive/data/ESAdocs/federal_register/fr3840.pdf	0	1	20	12	41	0	0	74	50
/datadrive/data/ESAdocs/federal_register/fr3841.pdf	1	0	0	5	9	0	0	15	11
/datadrive/data/ESAdocs/federal_register/fr3842.pdf	0	0	1	0	17	2	3	23	21
/datadrive/data/ESAdocs/federal_register/fr3843.pdf	3	0	2	6	7	0	0	18	8
/datadrive/data/ESAdocs/federal_register/fr3844.pdf	2	0	1	0	10	0	2	15	13
/datadrive/data/ESAdocs/federal_register/fr3847.pdf	3	0	8	4	41	0	0	56	89
/datadrive/data/ESAdocs/federal_register/fr3848.pdf	1	0	15	9	40	0	0	65	50
/datadrive/data/ESAdocs/federal_register/fr3849.pdf	1	1	0	0	23	3	1	29	35
/datadrive/data/ESAdocs/federal_register/fr3851.pdf	0	0	0	0	5	0	0	5	5
/datadrive/data/ESAdocs/federal_register/fr3852.pdf	0	0	0	0	0	0	0	0	1
/datadrive/data/ESAdocs/federal_register/fr3854.pdf	3	0	0	0	22	0	0	25	36
/datadrive/data/ESAdocs/federal_register/fr3856.pdf	0	0	0	0	0	0	0	0	1
/datadrive/data/ESAdocs/federal_register/fr3859.pdf	0	0	1	0	1	0	0	2	2
/datadrive/data/ESAdocs/federal_register/fr3861.pdf	0	0	0	0	1	0	0	1	1
/datadrive/data/ESAdocs/federal_register/fr3862.pdf	0	0	0	0	24	0	0	24	41
/datadrive/data/ESAdocs/federal_register/fr3863.pdf	0	0	0	0	2	0	0	2	2
/datadrive/data/ESAdocs/federal_register/fr3864.pdf	2	0	0	1	15	0	0	18	24
/datadrive/data/ESAdocs/federal_register/fr3866.pdf	0	0	0	0	2	0	0	2	2
/datadrive/data/ESAdocs/federal_register/fr3867.pdf	0	0	0	0	1	0	0	1	2
/datadrive/data/ESAdocs/federal_register/fr3868.pdf	0	0	0	0	0	0	0	0	2
/datadrive/data/ESAdocs/federal_register/fr3869.pdf	0	0	0	0	1	0	0	1	2
/datadrive/data/ESAdocs/federal_register/fr386.pdf	0	0	0	0	2	0	0	2	4
/datadrive/data/ESAdocs/federal_register/fr3870.pdf	0	0	0	0	2	0	0	2	2
/datadrive/data/ESAdocs/federal_register/fr3871.pdf	0	0	0	0	14	0	0	14	25
/datadrive/data/ESAdocs/federal_register/fr3872.pdf	0	0	0	0	1	1	0	2	2
/datadrive/data/ESAdocs/federal_register/fr3875.pdf	1	0	0	0	2	0	0	3	2
/datadrive/data/ESAdocs/federal_register/fr3876.pdf	2	0	1	1	19	0	0	23	50
/datadrive/data/ESAdocs/federal_register/fr3877.pdf	3	1	0	2	16	0	0	22	18
/datadrive/data/ESAdocs/federal_register/fr3879.pdf	0	0	2	0	30	8	6	46	95
/datadrive/data/ESAdocs/federal_register/fr387.pdf	0	0	0	0	2	0	0	2	2
/datadrive/data/ESAdocs/federal_register/fr3880.pdf	0	0	2	0	16	0	0	18	25
/datadrive/data/ESAdocs/federal_register/fr3883.pdf	7	1	2	4	18	4	3	39	23
/datadrive/data/ESAdocs/federal_register/fr3884.pdf	2	0	0	0	29	6	11	48	31
/datadrive/data/ESAdocs/federal_register/fr3885.pdf	14	1	4	3	18	3	3	46	23
/datadrive/data/ESAdocs/federal_register/fr3886.pdf	1	0	2	1	10	1	0	15	15
/datadrive/data/ESAdocs/federal_register/fr3887.pdf	2	3	1	1	11	0	0	18	26
/datadrive/data/ESAdocs/federal_register/fr3888.pdf	4	2	3	0	12	0	0	21	13
/datadrive/data/ESAdocs/federal_register/fr3889.pdf	0	16	17	9	30	0	0	72	50
/datadrive/data/ESAdocs/federal_register/fr3891.pdf	0	0	32	12	40	0	0	84	50
/datadrive/data/ESAdocs/federal_register/fr3893.pdf	0	1	0	3	9	0	0	13	11
/datadrive/data/ESAdocs/federal_register/fr3894.pdf	0	2	0	0	10	1	1	14	11
/datadrive/data/ESAdocs/federal_register/fr3895.pdf	0	0	0	0	2	0	0	2	2
/datadrive/data/ESAdocs/federal_register/fr3896.pdf	0	0	0	0	1	0	0	1	1
/datadrive/data/ESAdocs/federal_register/fr3897.pdf	0	0	0	0	2	0	0	2	2
/datadrive/data/ESAdocs/federal_register/fr3899.pdf	0	0	0	0	2	0	0	2	2
/datadrive/data/ESAdocs/federal_register/fr3900.pdf	0	0	0	0	2	0	0	2	3
/datadrive/data/ESAdocs/federal_register/fr3902.pdf	1	1	0	0	21	4	0	27	58
/datadrive/data/ESAdocs/federal_register/fr3903.pdf	2	1	3	1	14	0	1	22	15
/datadrive/data/ESAdocs/federal_register/fr3907.pdf	0	0	0	0	2	0	0	2	2
/datadrive/data/ESAdocs/federal_register/fr3925.pdf	9	1	3	7	13	0	0	33	14
/datadrive/data/ESAdocs/federal_register/fr3926.pdf	0	0	0	0	2	0	0	2	3
/datadrive/data/ESAdocs/federal_register/fr3927.pdf	0	0	0	0	0	0	0	0	1
/datadrive/data/ESAdocs/federal_register/fr3928.pdf	0	0	0	0	8	0	0	8	9
/datadrive/data/ESAdocs/federal_register/fr3929.pdf	0	0	0	0	0	0	0	0	1
/datadrive/data/ESAdocs/federal_register/fr3930.pdf	3	0	0	0	9	2	7	21	11
/datadrive/data/ESAdocs/federal_register/fr3932.pdf	7	2	3	5	10	1	0	28	10
/datadrive/data/ESAdocs/federal_register/fr3933.pdf	0	0	0	0	6	0	1	7	9
/datadrive/data/ESAdocs/federal_register/fr3934.pdf	0	0	2	0	21	3	1	27	32
/datadrive/data/ESAdocs/federal_register/fr3935.pdf	2	0	1	0	15	10	6	34	46
/datadrive/data/ESAdocs/federal_register/fr3936.pdf	11	0	2	1	21	7	9	51	39
/datadrive/data/ESAdocs/federal_register/fr3939.pdf	0	0	0	0	0	0	0	0	2
/datadrive/data/ESAdocs/federal_register/fr3940.pdf	0	0	0	0	0	0	0	0	2
/datadrive/data/ESAdocs/federal_register/fr3941.pdf	0	0	0	0	2	0	0	2	2
/datadrive/data/ESAdocs/federal_register/fr3942.pdf	0	0	0	0	2	0	0	2	3
/datadrive/data/ESAdocs/federal_register/fr3943.pdf	0	0	1	0	37	4	4	46	81
/datadrive/data/ESAdocs/federal_register/fr3945.pdf	3	0	0	0	10	0	0	13	10
/datadrive/data/ESAdocs/federal_register/fr3946.pdf	0	0	0	0	0	0	0	0	2
/datadrive/data/ESAdocs/federal_register/fr3947.pdf	0	0	0	0	19	2	1	22	37
/datadrive/data/ESAdocs/federal_register/fr3948.pdf	0	0	0	0	2	0	0	2	2
/datadrive/data/ESAdocs/federal_register/fr3949.pdf	0	0	1	0	1	0	0	2	3
/datadrive/data/ESAdocs/federal_register/fr394.pdf	0	0	0	1	1	0	0	2	2
/datadrive/data/ESAdocs/federal_register/fr3952.pdf	0	1	1	0	1	0	0	3	2
/datadrive/data/ESAdocs/federal_register/fr3954.pdf	0	0	0	0	2	0	1	3	2
/datadrive/data/ESAdocs/federal_register/fr3955.pdf	0	0	0	0	2	0	0	2	3
/datadrive/data/ESAdocs/federal_register/fr3956.pdf	0	0	0	0	2	0	0	2	2
/datadrive/data/ESAdocs/federal_register/fr3957.pdf	0	0	0	0	7	0	1	8	20
/datadrive/data/ESAdocs/federal_register/fr3958.pdf	1	0	2	0	47	6	22	78	50
/datadrive/data/ESAdocs/federal_register/fr3959.pdf	1	0	0	0	2	0	0	3	2
/datadrive/data/ESAdocs/federal_register/fr395.pdf	0	0	0	2	1	0	0	3	2
/datadrive/data/ESAdocs/federal_register/fr3960.pdf	0	0	0	1	1	0	0	2	2
/datadrive/data/ESAdocs/federal_register/fr3961.pdf	0	0	0	0	2	0	0	2	2
/datadrive/data/ESAdocs/federal_register/fr3962.pdf	0	0	0	0	2	0	0	2	2
/datadrive/data/ESAdocs/federal_register/fr3963.pdf	0	0	0	0	2	0	0	2	2
/datadrive/data/ESAdocs/federal_register/fr3964.pdf	1	1	1	0	2	0	0	5	2
/datadrive/data/ESAdocs/federal_register/fr3965.pdf	0	0	0	0	4	1	3	8	4
/datadrive/data/ESAdocs/federal_register/fr3966.pdf	0	0	0	0	1	0	0	1	1
/datadrive/data/ESAdocs/federal_register/fr3967.pdf	0	0	1	0	2	0	1	4	2
/datadrive/data/ESAdocs/federal_register/fr3968.pdf	1	0	0	0	2	0	0	3	2
/datadrive/data/ESAdocs/federal_register/fr3969.pdf	0	0	1	0	16	0	0	17	20
/datadrive/data/ESAdocs/federal_register/fr3970.pdf	0	0	1	0	17	0	0	18	36
/datadrive/data/ESAdocs/federal_register/fr3971.pdf	0	0	0	0	0	0	0	0	2
/datadrive/data/ESAdocs/federal_register/fr3972.pdf	3	0	4	1	21	1	0	30	41
/datadrive/data/ESAdocs/federal_register/fr3974.pdf	4	0	1	1	10	0	0	16	14
/datadrive/data/ESAdocs/federal_register/fr3975.pdf	1	0	0	0	15	8	0	24	25
/datadrive/data/ESAdocs/federal_register/fr3976.pdf	8	1	0	2	24	0	0	35	33
/datadrive/data/ESAdocs/federal_register/fr3977.pdf	0	0	0	0	1	0	0	1	3
/datadrive/data/ESAdocs/federal_register/fr397.pdf	0	0	0	1	2	0	0	3	3
/datadrive/data/ESAdocs/federal_register/fr3980.pdf	0	0	0	0	1	0	0	1	2
/datadrive/data/ESAdocs/federal_register/fr3981.pdf	0	0	0	0	1	0	0	1	2
/datadrive/data/ESAdocs/federal_register/fr3982.pdf	0	0	0	0	0	0	0	0	2
/datadrive/data/ESAdocs/federal_register/fr3983.pdf	3	0	1	2	22	3	0	31	35
/datadrive/data/ESAdocs/federal_register/fr3984.pdf	0	0	0	0	0	0	0	0	2
/datadrive/data/ESAdocs/federal_register/fr3985.pdf	0	0	0	0	17	0	1	18	41
/datadrive/data/ESAdocs/federal_register/fr3986.pdf	2	2	6	1	13	0	0	24	13
/datadrive/data/ESAdocs/federal_register/fr3988.pdf	0	0	0	0	1	0	0	1	2
/datadrive/data/ESAdocs/federal_register/fr3989.pdf	0	0	0	0	0	0	0	0	3
/datadrive/data/ESAdocs/federal_register/fr398.pdf	0	0	0	0	5	0	1	6	6
/datadrive/data/ESAdocs/federal_register/fr3990.pdf	0	0	0	0	1	0	0	1	2
/datadrive/data/ESAdocs/federal_register/fr3991.pdf	0	0	0	0	1	0	0	1	2
/datadrive/data/ESAdocs/federal_register/fr3992.pdf	0	0	0	0	1	0	0	1	2
/datadrive/data/ESAdocs/federal_register/fr3993.pdf	0	0	0	0	3	0	0	3	3
/datadrive/data/ESAdocs/federal_register/fr3994.pdf	1	0	0	0	2	1	1	5	3
/datadrive/data/ESAdocs/federal_register/fr3995.pdf	0	0	0	0	2	0	0	2	2
/datadrive/data/ESAdocs/federal_register/fr3996.pdf	0	1	0	0	1	0	0	2	1
/datadrive/data/ESAdocs/federal_register/fr3997.pdf	0	0	0	0	3	0	0	3	4
/datadrive/data/ESAdocs/federal_register/fr3998.pdf	1	0	0	0	2	0	1	4	2
/datadrive/data/ESAdocs/federal_register/fr3999.pdf	1	0	0	0	2	0	1	4	2
/datadrive/data/ESAdocs/federal_register/fr4002.pdf	0	0	0	0	1	0	0	1	2
/datadrive/data/ESAdocs/federal_register/fr4003.pdf	0	0	0	0	1	0	0	1	2
/datadrive/data/ESAdocs/federal_register/fr4006.pdf	1	0	1	0	16	0	0	18	25
/datadrive/data/ESAdocs/federal_register/fr4007.pdf	6	1	4	2	9	0	1	23	10
/datadrive/data/ESAdocs/federal_register/fr4008.pdf	0	0	0	0	2	0	0	2	2
/datadrive/data/ESAdocs/federal_register/fr4009.pdf	0	0	0	0	1	0	0	1	1
/datadrive/data/ESAdocs/federal_register/fr4011.pdf	0	0	0	0	2	0	0	2	2
/datadrive/data/ESAdocs/federal_register/fr4012.pdf	0	0	0	0	1	0	0	1	2
/datadrive/data/ESAdocs/federal_register/fr4014.pdf	1	0	0	0	1	0	0	2	2
/datadrive/data/ESAdocs/federal_register/fr4016.pdf	0	0	0	0	0	0	0	0	3
/datadrive/data/ESAdocs/federal_register/fr4017.pdf	2	13	7	2	40	0	1	65	56
/datadrive/data/ESAdocs/federal_register/fr4018.pdf	1	0	0	0	6	0	0	7	7
/datadrive/data/ESAdocs/federal_register/fr4019.pdf	0	0	0	0	0	0	0	0	2
/datadrive/data/ESAdocs/federal_register/fr4021.pdf	0	0	0	0	2	0	1	3	2
/datadrive/data/ESAdocs/federal_register/fr4022.pdf	0	0	0	0	2	0	0	2	2
/datadrive/data/ESAdocs/federal_register/fr4024.pdf	0	0	0	0	2	0	0	2	2
/datadrive/data/ESAdocs/federal_register/fr4025.pdf	0	0	0	0	0	0	0	0	1
/datadrive/data/ESAdocs/federal_register/fr4026.pdf	0	0	0	0	25	0	0	25	28
/datadrive/data/ESAdocs/federal_register/fr4027.pdf	0	0	0	0	1	0	0	1	2
/datadrive/data/ESAdocs/federal_register/fr4028.pdf	0	0	1	0	2	0	1	4	2
/datadrive/data/ESAdocs/federal_register/fr4029.pdf	0	0	0	0	2	0	0	2	2
/datadrive/data/ESAdocs/federal_register/fr402.pdf	0	0	1	0	1	0	0	2	3
/datadrive/data/ESAdocs/federal_register/fr4031.pdf	1	10	0	0	41	2	3	57	50
/datadrive/data/ESAdocs/federal_register/fr4032.pdf	0	0	0	0	1	0	0	1	2
/datadrive/data/ESAdocs/federal_register/fr4034.pdf	0	0	0	0	4	0	0	4	4
/datadrive/data/ESAdocs/federal_register/fr4035.pdf	10	1	12	6	40	0	25	94	50
/datadrive/data/ESAdocs/federal_register/fr4036.pdf	0	0	0	0	26	0	10	36	50
/datadrive/data/ESAdocs/federal_register/fr4037.pdf	0	0	0	0	2	0	2	4	7
/datadrive/data/ESAdocs/federal_register/fr4039.pdf	0	0	0	0	2	0	0	2	2
/datadrive/data/ESAdocs/federal_register/fr4043.pdf	2	0	3	0	29	0	0	34	42
/datadrive/data/ESAdocs/federal_register/fr4044.pdf	0	0	0	0	0	0	0	0	2
/datadrive/data/ESAdocs/federal_register/fr4046.pdf	0	0	0	0	1	0	0	1	1
/datadrive/data/ESAdocs/federal_register/fr4047.pdf	0	0	0	0	2	0	0	2	2
/datadrive/data/ESAdocs/federal_register/fr4048.pdf	0	0	0	0	0	0	0	0	1
/datadrive/data/ESAdocs/federal_register/fr4049.pdf	1	0	0	0	3	1	1	6	3
/datadrive/data/ESAdocs/federal_register/fr4050.pdf	0	0	0	0	2	0	0	2	3
/datadrive/data/ESAdocs/federal_register/fr4052.pdf	0	0	0	0	1	0	0	1	2
/datadrive/data/ESAdocs/federal_register/fr4053.pdf	0	0	19	12	40	0	0	71	50
/datadrive/data/ESAdocs/federal_register/fr4054.pdf	1	0	0	0	1	0	0	2	1
/datadrive/data/ESAdocs/federal_register/fr4055.pdf	0	0	0	0	2	0	0	2	2
/datadrive/data/ESAdocs/federal_register/fr4056.pdf	0	0	0	0	1	0	0	1	2
/datadrive/data/ESAdocs/federal_register/fr4059.pdf	0	0	7	4	36	0	1	48	50
/datadrive/data/ESAdocs/federal_register/fr405.pdf	0	0	0	0	2	0	1	3	4
/datadrive/data/ESAdocs/federal_register/fr4060.pdf	1	0	0	0	2	0	0	3	2
/datadrive/data/ESAdocs/federal_register/fr4061.pdf	41	9	8	0	72	0	0	130	73
/datadrive/data/ESAdocs/federal_register/fr4064.pdf	0	0	0	0	2	0	0	2	2
/datadrive/data/ESAdocs/federal_register/fr4066.pdf	0	0	0	0	2	0	0	2	2
/datadrive/data/ESAdocs/federal_register/fr4068.pdf	0	0	0	0	2	0	0	2	2
/datadrive/data/ESAdocs/federal_register/fr4069.pdf	0	0	3	1	17	6	1	28	42
/datadrive/data/ESAdocs/federal_register/fr4072.pdf	2	1	3	1	20	0	2	29	24
/datadrive/data/ESAdocs/federal_register/fr4073.pdf	2	0	2	1	10	0	0	15	11
/datadrive/data/ESAdocs/federal_register/fr4074.pdf	0	0	0	0	1	0	0	1	2
/datadrive/data/ESAdocs/federal_register/fr4076.pdf	3	0	1	3	19	1	2	29	21
/datadrive/data/ESAdocs/federal_register/fr4077.pdf	0	0	1	1	11	1	0	14	18
/datadrive/data/ESAdocs/federal_register/fr4079.pdf	3	6	0	1	18	0	2	30	30
/datadrive/data/ESAdocs/federal_register/fr4080.pdf	1	0	0	0	10	7	3	21	22
/datadrive/data/ESAdocs/federal_register/fr4081.pdf	0	0	0	0	2	1	0	3	2
/datadrive/data/ESAdocs/federal_register/fr4082.pdf	0	0	0	0	3	0	0	3	3
/datadrive/data/ESAdocs/federal_register/fr4083.pdf	1	0	0	0	2	0	1	4	2
/datadrive/data/ESAdocs/federal_register/fr4084.pdf	0	0	0	0	0	0	0	0	1
/datadrive/data/ESAdocs/federal_register/fr4086.pdf	0	0	2	1	45	0	1	49	50
/datadrive/data/ESAdocs/federal_register/fr4087.pdf	1	1	2	0	18	0	0	22	50
/datadrive/data/ESAdocs/federal_register/fr4092.pdf	0	0	0	0	14	0	0	14	15
/datadrive/data/ESAdocs/federal_register/fr4094.pdf	0	0	0	0	2	0	0	2	2
/datadrive/data/ESAdocs/federal_register/fr4095.pdf	6	1	1	2	17	3	0	30	21
/datadrive/data/ESAdocs/federal_register/fr4098.pdf	0	0	0	0	2	0	0	2	2
/datadrive/data/ESAdocs/federal_register/fr40.pdf	2	0	0	0	3	0	0	5	3
/datadrive/data/ESAdocs/federal_register/fr4102.pdf	8	3	4	2	21	1	4	43	24
/datadrive/data/ESAdocs/federal_register/fr4103.pdf	0	0	1	0	19	0	0	20	23
/datadrive/data/ESAdocs/federal_register/fr4105.pdf	0	0	0	0	2	0	0	2	2
/datadrive/data/ESAdocs/federal_register/fr4107.pdf	0	0	0	0	1	0	0	1	1
/datadrive/data/ESAdocs/federal_register/fr4108.pdf	0	0	0	0	1	0	0	1	1
/datadrive/data/ESAdocs/federal_register/fr4109.pdf	0	0	0	0	0	0	0	0	1
/datadrive/data/ESAdocs/federal_register/fr410.pdf	0	0	0	0	2	0	0	2	3
/datadrive/data/ESAdocs/federal_register/fr4110.pdf	3	0	0	0	11	0	0	14	13
/datadrive/data/ESAdocs/federal_register/fr4111.pdf	1	0	1	2	7	0	0	11	8
/datadrive/data/ESAdocs/federal_register/fr4112.pdf	0	0	0	0	3	0	2	5	3
/datadrive/data/ESAdocs/federal_register/fr4115.pdf	0	0	34	14	45	0	1	94	50
/datadrive/data/ESAdocs/federal_register/fr4117.pdf	1	0	0	0	27	0	1	29	50
/datadrive/data/ESAdocs/federal_register/fr4118.pdf	0	0	0	0	1	0	0	1	2
/datadrive/data/ESAdocs/federal_register/fr411.pdf	0	0	0	0	1	0	0	1	3
/datadrive/data/ESAdocs/federal_register/fr4120.pdf	0	0	0	0	2	2	1	5	2
/datadrive/data/ESAdocs/federal_register/fr4122.pdf	0	0	0	0	3	0	0	3	4
/datadrive/data/ESAdocs/federal_register/fr4124.pdf	1	0	0	0	37	0	0	38	50
/datadrive/data/ESAdocs/federal_register/fr4125.pdf	2	0	3	1	25	0	0	31	50
/datadrive/data/ESAdocs/federal_register/fr4131.pdf	0	0	3	2	14	2	0	21	32
/datadrive/data/ESAdocs/federal_register/fr4133.pdf	0	0	0	0	8	0	0	8	8
/datadrive/data/ESAdocs/federal_register/fr4134.pdf	0	0	0	0	0	0	0	0	1
/datadrive/data/ESAdocs/federal_register/fr4135.pdf	1	0	2	1	24	0	0	28	50
/datadrive/data/ESAdocs/federal_register/fr4137.pdf	0	0	0	0	19	0	0	19	27
/datadrive/data/ESAdocs/federal_register/fr4138.pdf	1	0	2	0	15	6	6	30	50
/datadrive/data/ESAdocs/federal_register/fr4139.pdf	0	0	0	0	2	1	0	3	2
/datadrive/data/ESAdocs/federal_register/fr4140.pdf	0	1	19	8	39	0	1	68	50
/datadrive/data/ESAdocs/federal_register/fr4141.pdf	1	0	3	1	29	1	1	36	50
/datadrive/data/ESAdocs/federal_register/fr4144.pdf	0	0	0	0	9	0	0	9	33
/datadrive/data/ESAdocs/federal_register/fr4149.pdf	1	1	2	1	3	0	0	8	3
/datadrive/data/ESAdocs/federal_register/fr414.pdf	0	0	0	0	0	1	0	1	2
/datadrive/data/ESAdocs/federal_register/fr4152.pdf	3	2	3	0	11	0	0	19	13
/datadrive/data/ESAdocs/federal_register/fr4153.pdf	0	1	0	0	1	0	0	2	1
/datadrive/data/ESAdocs/federal_register/fr4154.pdf	0	0	0	0	2	0	0	2	2
/datadrive/data/ESAdocs/federal_register/fr4155.pdf	9	1	3	3	19	0	0	35	22
/datadrive/data/ESAdocs/federal_register/fr4157.pdf	0	0	0	0	2	0	0	2	2
/datadrive/data/ESAdocs/federal_register/fr415.pdf	0	1	1	0	2	0	0	4	3
/datadrive/data/ESAdocs/federal_register/fr4160.pdf	2	0	4	0	46	3	7	62	50
/datadrive/data/ESAdocs/federal_register/fr4164.pdf	0	0	2	0	11	1	0	14	18
/datadrive/data/ESAdocs/federal_register/fr4165.pdf	0	0	0	0	1	0	0	1	1
/datadrive/data/ESAdocs/federal_register/fr4166.pdf	0	0	0	0	2	0	0	2	2
/datadrive/data/ESAdocs/federal_register/fr4167.pdf	1	0	0	0	2	0	0	3	2
/datadrive/data/ESAdocs/federal_register/fr416.pdf	1	1	1	0	2	0	0	5	4
/datadrive/data/ESAdocs/federal_register/fr4174.pdf	1	0	0	0	2	0	0	3	2
/datadrive/data/ESAdocs/federal_register/fr4175.pdf	0	0	0	0	1	0	0	1	1
/datadrive/data/ESAdocs/federal_register/fr4176.pdf	0	0	0	0	2	0	0	2	2
/datadrive/data/ESAdocs/federal_register/fr4177.pdf	0	0	0	0	1	0	0	1	1
/datadrive/data/ESAdocs/federal_register/fr4178.pdf	0	0	0	0	2	0	0	2	2
/datadrive/data/ESAdocs/federal_register/fr4179.pdf	0	0	0	0	2	0	1	3	2
/datadrive/data/ESAdocs/federal_register/fr4180.pdf	0	0	0	0	2	0	1	3	2
/datadrive/data/ESAdocs/federal_register/fr4181.pdf	0	0	0	0	2	0	0	2	2
/datadrive/data/ESAdocs/federal_register/fr4183.pdf	0	0	0	0	2	1	0	3	2
/datadrive/data/ESAdocs/federal_register/fr4185.pdf	0	0	0	0	0	0	0	0	2
/datadrive/data/ESAdocs/federal_register/fr4187.pdf	1	0	0	0	2	0	0	3	2
/datadrive/data/ESAdocs/federal_register/fr4188.pdf	0	0	0	0	2	0	0	2	2
/datadrive/data/ESAdocs/federal_register/fr4190.pdf	0	0	0	0	2	0	0	2	3
/datadrive/data/ESAdocs/federal_register/fr4191.pdf	0	2	0	0	1	0	0	3	2
/datadrive/data/ESAdocs/federal_register/fr4193.pdf	1	0	0	0	2	0	0	3	2
/datadrive/data/ESAdocs/federal_register/fr4194.pdf	1	0	1	2	7	0	0	11	9
/datadrive/data/ESAdocs/federal_register/fr4195.pdf	0	0	0	0	2	0	0	2	2
/datadrive/data/ESAdocs/federal_register/fr4196.pdf	0	0	0	0	5	0	0	5	9
/datadrive/data/ESAdocs/federal_register/fr4198.pdf	0	0	0	0	1	0	0	1	2
/datadrive/data/ESAdocs/federal_register/fr4200.pdf	0	0	1	0	2	0	0	3	4
/datadrive/data/ESAdocs/federal_register/fr4201.pdf	0	1	0	0	2	0	1	4	2
/datadrive/data/ESAdocs/federal_register/fr4203.pdf	1	0	0	0	0	0	0	1	2
/datadrive/data/ESAdocs/federal_register/fr4205.pdf	0	0	0	0	1	0	1	2	2
/datadrive/data/ESAdocs/federal_register/fr4207.pdf	0	0	0	0	4	0	0	4	4
/datadrive/data/ESAdocs/federal_register/fr4208.pdf	0	0	0	0	2	0	0	2	2
/datadrive/data/ESAdocs/federal_register/fr4209.pdf	0	1	1	0	2	0	0	4	2
/datadrive/data/ESAdocs/federal_register/fr4210.pdf	0	1	1	0	2	0	0	4	2
/datadrive/data/ESAdocs/federal_register/fr4211.pdf	0	1	1	0	2	0	0	4	2
/datadrive/data/ESAdocs/federal_register/fr4212.pdf	0	0	0	0	2	0	0	2	2
/datadrive/data/ESAdocs/federal_register/fr4214.pdf	0	0	0	0	2	0	0	2	2
/datadrive/data/ESAdocs/federal_register/fr4215.pdf	1	0	0	0	4	0	0	5	4
/datadrive/data/ESAdocs/federal_register/fr4217.pdf	14	2	7	5	22	1	0	51	23
/datadrive/data/ESAdocs/federal_register/fr4218.pdf	1	0	1	0	18	4	3	27	31
/datadrive/data/ESAdocs/federal_register/fr4219.pdf	1	0	0	0	5	0	0	6	8
/datadrive/data/ESAdocs/federal_register/fr4220.pdf	0	0	0	0	1	0	0	1	1
/datadrive/data/ESAdocs/federal_register/fr4221.pdf	0	0	0	0	5	0	0	5	8
/datadrive/data/ESAdocs/federal_register/fr4223.pdf	0	0	0	0	2	0	0	2	3
/datadrive/data/ESAdocs/federal_register/fr4226.pdf	1	1	0	0	4	0	0	6	6
/datadrive/data/ESAdocs/federal_register/fr4228.pdf	2	4	3	0	18	0	0	27	19
/datadrive/data/ESAdocs/federal_register/fr4230.pdf	1	0	0	0	12	0	0	13	17
/datadrive/data/ESAdocs/federal_register/fr4231.pdf	0	0	0	0	3	0	0	3	3
/datadrive/data/ESAdocs/federal_register/fr4233.pdf	0	0	0	0	3	0	0	3	4
/datadrive/data/ESAdocs/federal_register/fr4234.pdf	0	0	0	0	14	1	0	15	22
/datadrive/data/ESAdocs/federal_register/fr4235.pdf	0	0	0	0	1	0	0	1	2
/datadrive/data/ESAdocs/federal_register/fr4238.pdf	0	0	0	0	2	0	0	2	2
/datadrive/data/ESAdocs/federal_register/fr4239.pdf	0	0	4	0	17	1	5	27	24
/datadrive/data/ESAdocs/federal_register/fr423.pdf	0	0	0	0	1	0	0	1	1
/datadrive/data/ESAdocs/federal_register/fr4240.pdf	0	0	1	2	4	0	0	7	9
/datadrive/data/ESAdocs/federal_register/fr4242.pdf	0	0	0	0	2	0	0	2	3
/datadrive/data/ESAdocs/federal_register/fr4243.pdf	0	0	0	0	1	0	0	1	2
/datadrive/data/ESAdocs/federal_register/fr4244.pdf	0	0	0	0	2	0	0	2	2
/datadrive/data/ESAdocs/federal_register/fr4246.pdf	9	1	1	0	25	0	0	36	30
/datadrive/data/ESAdocs/federal_register/fr4247.pdf	0	0	0	0	3	0	0	3	3
/datadrive/data/ESAdocs/federal_register/fr4248.pdf	1	1	0	0	5	0	0	7	5
/datadrive/data/ESAdocs/federal_register/fr424.pdf	0	0	1	0	1	0	0	2	3
/datadrive/data/ESAdocs/federal_register/fr4253.pdf	0	0	0	0	2	1	0	3	2
/datadrive/data/ESAdocs/federal_register/fr4254.pdf	0	0	0	0	1	0	0	1	2
/datadrive/data/ESAdocs/federal_register/fr4255.pdf	0	0	0	0	1	0	0	1	1
/datadrive/data/ESAdocs/federal_register/fr4256.pdf	0	0	0	0	1	0	0	1	2
/datadrive/data/ESAdocs/federal_register/fr4257.pdf	0	0	0	0	4	0	0	4	4
/datadrive/data/ESAdocs/federal_register/fr4258.pdf	0	0	0	0	2	0	0	2	2
/datadrive/data/ESAdocs/federal_register/fr425.pdf	0	0	0	0	3	0	0	3	4
/datadrive/data/ESAdocs/federal_register/fr4260.pdf	0	0	0	0	2	0	0	2	3
/datadrive/data/ESAdocs/federal_register/fr4261.pdf	0	1	0	0	2	0	0	3	2
/datadrive/data/ESAdocs/federal_register/fr4262.pdf	1	0	0	0	2	0	0	3	2
/datadrive/data/ESAdocs/federal_register/fr4263.pdf	1	0	0	0	2	0	0	3	2
/datadrive/data/ESAdocs/federal_register/fr4264.pdf	0	0	0	0	2	0	0	2	2
/datadrive/data/ESAdocs/federal_register/fr4265.pdf	0	0	0	0	2	0	0	2	2
/datadrive/data/ESAdocs/federal_register/fr4266.pdf	1	0	0	0	2	0	0	3	2
/datadrive/data/ESAdocs/federal_register/fr4267.pdf	0	0	0	0	4	0	0	4	9
/datadrive/data/ESAdocs/federal_register/fr4268.pdf	0	0	0	0	4	0	0	4	10
/datadrive/data/ESAdocs/federal_register/fr4269.pdf	0	0	0	0	2	1	1	4	2
/datadrive/data/ESAdocs/federal_register/fr426.pdf	0	0	0	2	3	0	0	5	4
/datadrive/data/ESAdocs/federal_register/fr4270.pdf	0	1	0	0	3	0	1	5	3
/datadrive/data/ESAdocs/federal_register/fr4271.pdf	0	0	0	0	2	0	0	2	2
/datadrive/data/ESAdocs/federal_register/fr4272.pdf	0	0	0	0	2	0	0	2	2
/datadrive/data/ESAdocs/federal_register/fr4273.pdf	0	0	0	0	4	0	3	7	5
/datadrive/data/ESAdocs/federal_register/fr4275.pdf	0	0	0	0	2	0	1	3	3
/datadrive/data/ESAdocs/federal_register/fr4276.pdf	0	0	0	0	2	0	0	2	2
/datadrive/data/ESAdocs/federal_register/fr4277.pdf	0	0	0	0	2	0	0	2	2
/datadrive/data/ESAdocs/federal_register/fr4278.pdf	12	2	3	1	34	2	4	58	38
/datadrive/data/ESAdocs/federal_register/fr4279.pdf	0	0	0	0	2	0	1	3	2
/datadrive/data/ESAdocs/federal_register/fr4280.pdf	0	0	0	0	2	1	2	5	2
/datadrive/data/ESAdocs/federal_register/fr4283.pdf	0	0	0	0	0	0	0	0	2
/datadrive/data/ESAdocs/federal_register/fr4287.pdf	1	0	2	0	15	0	0	18	18
/datadrive/data/ESAdocs/federal_register/fr4288.pdf	0	0	0	0	12	1	1	14	14
/datadrive/data/ESAdocs/federal_register/fr4289.pdf	0	0	0	0	6	1	1	8	6
/datadrive/data/ESAdocs/federal_register/fr4290.pdf	0	1	0	0	0	0	0	1	1
/datadrive/data/ESAdocs/federal_register/fr4292.pdf	5	0	4	1	12	0	0	22	13
/datadrive/data/ESAdocs/federal_register/fr4294.pdf	0	0	0	0	2	0	0	2	2
/datadrive/data/ESAdocs/federal_register/fr4295.pdf	0	1	2	0	11	0	0	14	26
/datadrive/data/ESAdocs/federal_register/fr4299.pdf	1	0	0	0	7	1	2	11	13
/datadrive/data/ESAdocs/federal_register/fr429.pdf	0	0	0	1	2	0	0	3	3
/datadrive/data/ESAdocs/federal_register/fr42.pdf	0	0	0	0	0	0	0	0	1
/datadrive/data/ESAdocs/federal_register/fr4300.pdf	4	0	1	0	24	10	13	52	36
/datadrive/data/ESAdocs/federal_register/fr4301.pdf	0	0	1	0	4	0	0	5	5
/datadrive/data/ESAdocs/federal_register/fr4302.pdf	0	0	1	0	1	0	0	2	3
/datadrive/data/ESAdocs/federal_register/fr4303.pdf	0	0	0	0	17	0	0	17	23
/datadrive/data/ESAdocs/federal_register/fr4304.pdf	0	0	2	3	17	2	0	24	38
/datadrive/data/ESAdocs/federal_register/fr4305.pdf	0	0	3	0	17	0	0	20	27
/datadrive/data/ESAdocs/federal_register/fr4307.pdf	0	0	0	0	1	0	0	1	1
/datadrive/data/ESAdocs/federal_register/fr4309.pdf	2	0	4	2	15	0	0	23	18
/datadrive/data/ESAdocs/federal_register/fr4310.pdf	1	1	1	1	10	2	0	16	14
/datadrive/data/ESAdocs/federal_register/fr4315.pdf	0	0	0	0	2	1	0	3	2
/datadrive/data/ESAdocs/federal_register/fr4316.pdf	0	0	1	0	2	0	0	3	2
/datadrive/data/ESAdocs/federal_register/fr4319.pdf	0	0	0	0	2	0	0	2	2
/datadrive/data/ESAdocs/federal_register/fr431.pdf	0	0	0	0	3	0	0	3	3
/datadrive/data/ESAdocs/federal_register/fr4320.pdf	1	0	0	0	1	0	0	2	1
/datadrive/data/ESAdocs/federal_register/fr4321.pdf	0	0	0	0	1	0	0	1	1
/datadrive/data/ESAdocs/federal_register/fr4323.pdf	0	0	0	0	3	0	0	3	3
/datadrive/data/ESAdocs/federal_register/fr4324.pdf	1	0	0	0	3	1	1	6	3
/datadrive/data/ESAdocs/federal_register/fr4325.pdf	0	0	0	0	2	0	0	2	2
/datadrive/data/ESAdocs/federal_register/fr4326.pdf	0	0	0	1	1	0	0	2	2
/datadrive/data/ESAdocs/federal_register/fr4329.pdf	0	0	0	0	2	0	0	2	2
/datadrive/data/ESAdocs/federal_register/fr432.pdf	0	0	0	1	5	0	1	7	5
/datadrive/data/ESAdocs/federal_register/fr4330.pdf	0	0	0	0	2	0	0	2	3
/datadrive/data/ESAdocs/federal_register/fr4331.pdf	1	0	0	0	2	0	1	4	2
/datadrive/data/ESAdocs/federal_register/fr4333.pdf	0	0	0	0	5	0	0	5	5
/datadrive/data/ESAdocs/federal_register/fr4334.pdf	0	0	0	0	2	0	0	2	3
/datadrive/data/ESAdocs/federal_register/fr4335.pdf	1	0	1	0	3	0	0	5	4
/datadrive/data/ESAdocs/federal_register/fr4337.pdf	0	0	0	0	2	0	0	2	3
/datadrive/data/ESAdocs/federal_register/fr4338.pdf	0	0	0	0	1	0	0	1	2
/datadrive/data/ESAdocs/federal_register/fr433.pdf	0	0	0	0	2	0	0	2	4
/datadrive/data/ESAdocs/federal_register/fr4340.pdf	0	0	1	0	2	0	0	3	3
/datadrive/data/ESAdocs/federal_register/fr4341.pdf	13	0	8	0	45	0	0	66	50
/datadrive/data/ESAdocs/federal_register/fr4342.pdf	0	0	0	0	2	0	0	2	2
/datadrive/data/ESAdocs/federal_register/fr4343.pdf	1	0	0	1	2	0	0	4	2
/datadrive/data/ESAdocs/federal_register/fr4344.pdf	0	0	0	0	9	0	1	10	14
/datadrive/data/ESAdocs/federal_register/fr4346.pdf	0	0	0	0	4	0	0	4	5
/datadrive/data/ESAdocs/federal_register/fr4347.pdf	0	0	0	0	2	0	0	2	3
/datadrive/data/ESAdocs/federal_register/fr4348.pdf	0	0	0	0	7	0	2	9	11
/datadrive/data/ESAdocs/federal_register/fr4349.pdf	0	0	2	0	31	0	0	33	48
/datadrive/data/ESAdocs/federal_register/fr4350.pdf	0	0	0	0	1	0	0	1	1
/datadrive/data/ESAdocs/federal_register/fr4353.pdf	0	0	0	0	1	0	0	1	1
/datadrive/data/ESAdocs/federal_register/fr4354.pdf	0	0	0	0	2	0	0	2	2
/datadrive/data/ESAdocs/federal_register/fr4355.pdf	2	0	2	0	20	0	0	24	43
/datadrive/data/ESAdocs/federal_register/fr4356.pdf	0	0	0	0	1	0	0	1	1
/datadrive/data/ESAdocs/federal_register/fr4357.pdf	0	0	0	0	2	0	0	2	2
/datadrive/data/ESAdocs/federal_register/fr4359.pdf	0	0	1	0	11	7	0	19	24
/datadrive/data/ESAdocs/federal_register/fr4360.pdf	0	0	0	0	2	0	0	2	2
/datadrive/data/ESAdocs/federal_register/fr4361.pdf	0	0	0	0	2	0	0	2	2
/datadrive/data/ESAdocs/federal_register/fr4362.pdf	0	0	0	1	29	0	0	30	50
/datadrive/data/ESAdocs/federal_register/fr4365.pdf	0	0	0	0	2	0	0	2	2
/datadrive/data/ESAdocs/federal_register/fr4367.pdf	4	0	3	0	15	0	0	22	21
/datadrive/data/ESAdocs/federal_register/fr4369.pdf	20	6	5	1	24	0	0	56	27
/datadrive/data/ESAdocs/federal_register/fr4370.pdf	1	0	0	0	2	0	0	3	2
/datadrive/data/ESAdocs/federal_register/fr4371.pdf	0	0	0	0	2	0	0	2	2
/datadrive/data/ESAdocs/federal_register/fr4372.pdf	0	1	0	1	2	0	0	4	2
/datadrive/data/ESAdocs/federal_register/fr4377.pdf	0	0	0	0	2	1	1	4	2
/datadrive/data/ESAdocs/federal_register/fr4378.pdf	0	1	1	0	16	0	1	19	25
/datadrive/data/ESAdocs/federal_register/fr4379.pdf	0	0	0	0	3	0	1	4	3
/datadrive/data/ESAdocs/federal_register/fr437.pdf	0	0	0	0	4	0	2	6	10
/datadrive/data/ESAdocs/federal_register/fr4382.pdf	1	0	0	0	4	0	0	5	4
/datadrive/data/ESAdocs/federal_register/fr4384.pdf	0	0	0	0	2	0	0	2	2
/datadrive/data/ESAdocs/federal_register/fr4385.pdf	1	0	1	0	10	0	0	12	10
/datadrive/data/ESAdocs/federal_register/fr4386.pdf	1	0	0	1	7	1	0	10	8
/datadrive/data/ESAdocs/federal_register/fr4387.pdf	0	0	0	0	1	0	0	1	1
/datadrive/data/ESAdocs/federal_register/fr4391.pdf	0	0	3	0	5	0	0	8	9
/datadrive/data/ESAdocs/federal_register/fr4392.pdf	2	0	3	0	17	3	7	32	21
/datadrive/data/ESAdocs/federal_register/fr4396.pdf	0	0	0	0	2	0	0	2	2
/datadrive/data/ESAdocs/federal_register/fr4397.pdf	4	0	1	3	16	6	2	32	17
/datadrive/data/ESAdocs/federal_register/fr4402.pdf	0	0	0	0	8	0	1	9	12
/datadrive/data/ESAdocs/federal_register/fr4403.pdf	0	0	0	0	10	0	1	11	17
/datadrive/data/ESAdocs/federal_register/fr4405.pdf	2	0	6	1	44	5	0	58	73
/datadrive/data/ESAdocs/federal_register/fr4406.pdf	0	0	0	0	2	0	0	2	2
/datadrive/data/ESAdocs/federal_register/fr4409.pdf	0	0	1	0	2	0	0	3	2
/datadrive/data/ESAdocs/federal_register/fr4410.pdf	17	4	13	12	61	11	8	126	66
/datadrive/data/ESAdocs/federal_register/fr4412.pdf	4	1	1	1	13	4	1	25	15
/datadrive/data/ESAdocs/federal_register/fr4413.pdf	5	1	3	1	11	0	0	21	13
/datadrive/data/ESAdocs/federal_register/fr4414.pdf	1	0	1	0	18	0	0	20	23
/datadrive/data/ESAdocs/federal_register/fr4418.pdf	0	0	0	0	3	1	1	5	3
/datadrive/data/ESAdocs/federal_register/fr4419.pdf	0	0	0	0	2	1	1	4	2
/datadrive/data/ESAdocs/federal_register/fr4420.pdf	0	0	0	0	1	0	0	1	1
/datadrive/data/ESAdocs/federal_register/fr4422.pdf	3	0	1	0	20	4	8	36	31
/datadrive/data/ESAdocs/federal_register/fr4423.pdf	0	0	0	0	17	1	0	18	22
/datadrive/data/ESAdocs/federal_register/fr4424.pdf	0	0	0	0	6	0	0	6	6
/datadrive/data/ESAdocs/federal_register/fr4426.pdf	0	0	1	1	3	0	0	5	4
/datadrive/data/ESAdocs/federal_register/fr4427.pdf	0	0	1	0	14	0	1	16	22
/datadrive/data/ESAdocs/federal_register/fr4428.pdf	1	0	2	0	4	0	0	7	5
/datadrive/data/ESAdocs/federal_register/fr4429.pdf	0	0	0	0	3	0	0	3	3
/datadrive/data/ESAdocs/federal_register/fr4431.pdf	0	0	0	0	3	0	0	3	4
/datadrive/data/ESAdocs/federal_register/fr4432.pdf	0	0	1	0	3	1	0	5	3
/datadrive/data/ESAdocs/federal_register/fr4435.pdf	0	0	0	0	1	0	0	1	1
/datadrive/data/ESAdocs/federal_register/fr4438.pdf	0	0	0	0	5	0	0	5	5
/datadrive/data/ESAdocs/federal_register/fr443.pdf	1	0	0	0	2	0	0	3	4
/datadrive/data/ESAdocs/federal_register/fr4441.pdf	0	0	0	0	2	1	0	3	2
/datadrive/data/ESAdocs/federal_register/fr4442.pdf	0	0	0	0	1	0	0	1	1
/datadrive/data/ESAdocs/federal_register/fr4443.pdf	0	0	0	1	2	0	0	3	2
/datadrive/data/ESAdocs/federal_register/fr4444.pdf	0	0	0	0	2	0	0	2	2
/datadrive/data/ESAdocs/federal_register/fr4448.pdf	0	0	0	0	2	0	0	2	2
/datadrive/data/ESAdocs/federal_register/fr444.pdf	0	0	0	0	0	1	0	1	3
/datadrive/data/ESAdocs/federal_register/fr4451.pdf	0	0	0	0	2	0	0	2	2
/datadrive/data/ESAdocs/federal_register/fr4453.pdf	0	0	0	0	2	0	0	2	2
/datadrive/data/ESAdocs/federal_register/fr4454.pdf	1	0	0	0	2	0	0	3	2
/datadrive/data/ESAdocs/federal_register/fr4456.pdf	0	0	0	0	2	0	0	2	2
/datadrive/data/ESAdocs/federal_register/fr4458.pdf	0	0	0	0	1	0	1	2	2
/datadrive/data/ESAdocs/federal_register/fr4459.pdf	0	0	0	0	2	0	0	2	2
/datadrive/data/ESAdocs/federal_register/fr445.pdf	0	0	2	1	2	0	0	5	3
/datadrive/data/ESAdocs/federal_register/fr4461.pdf	3	0	2	4	16	8	2	35	17
/datadrive/data/ESAdocs/federal_register/fr4462.pdf	0	0	0	0	5	0	0	5	6
/datadrive/data/ESAdocs/federal_register/fr4463.pdf	0	0	0	0	1	0	0	1	2
/datadrive/data/ESAdocs/federal_register/fr4464.pdf	0	0	0	0	2	0	0	2	2
/datadrive/data/ESAdocs/federal_register/fr4465.pdf	4	0	0	0	6	0	0	10	6
/datadrive/data/ESAdocs/federal_register/fr4466.pdf	0	0	0	0	1	0	0	1	2
/datadrive/data/ESAdocs/federal_register/fr4467.pdf	1	3	0	0	45	0	1	50	46
/datadrive/data/ESAdocs/federal_register/fr4468.pdf	1	0	0	0	6	0	0	7	6
/datadrive/data/ESAdocs/federal_register/fr4469.pdf	1	0	1	0	21	0	0	23	36
/datadrive/data/ESAdocs/federal_register/fr446.pdf	0	0	0	1	1	0	0	2	3
/datadrive/data/ESAdocs/federal_register/fr4470.pdf	0	0	1	4	17	0	0	22	30
/datadrive/data/ESAdocs/federal_register/fr4471.pdf	7	1	4	3	32	5	3	55	50
/datadrive/data/ESAdocs/federal_register/fr4474.pdf	0	0	0	0	9	0	1	10	14
/datadrive/data/ESAdocs/federal_register/fr4475.pdf	0	0	0	0	1	0	0	1	3
/datadrive/data/ESAdocs/federal_register/fr4479.pdf	0	0	0	0	3	0	0	3	3
/datadrive/data/ESAdocs/federal_register/fr4480.pdf	1	0	0	0	6	0	0	7	6
/datadrive/data/ESAdocs/federal_register/fr4481.pdf	0	1	1	0	2	0	0	4	3
/datadrive/data/ESAdocs/federal_register/fr4482.pdf	0	0	0	0	0	0	0	0	1
/datadrive/data/ESAdocs/federal_register/fr4483.pdf	17	5	3	0	27	0	0	52	32
/datadrive/data/ESAdocs/federal_register/fr4484.pdf	0	0	0	0	3	0	0	3	5
/datadrive/data/ESAdocs/federal_register/fr4485.pdf	0	0	0	0	1	1	1	3	2
/datadrive/data/ESAdocs/federal_register/fr4487.pdf	0	0	0	0	4	0	0	4	4
/datadrive/data/ESAdocs/federal_register/fr4488.pdf	0	0	0	0	2	0	0	2	2
/datadrive/data/ESAdocs/federal_register/fr4490.pdf	1	0	1	2	12	0	0	16	19
/datadrive/data/ESAdocs/federal_register/fr4491.pdf	1	0	2	0	29	1	1	34	45
/datadrive/data/ESAdocs/federal_register/fr4492.pdf	0	0	1	0	18	6	0	25	26
/datadrive/data/ESAdocs/federal_register/fr4493.pdf	0	2	0	0	5	3	2	12	6
/datadrive/data/ESAdocs/federal_register/fr4494.pdf	2	0	3	0	7	0	0	12	10
/datadrive/data/ESAdocs/federal_register/fr4495.pdf	0	0	1	0	17	1	5	24	27
/datadrive/data/ESAdocs/federal_register/fr4496.pdf	0	0	0	0	20	0	0	20	50
/datadrive/data/ESAdocs/federal_register/fr4497.pdf	0	0	0	0	1	0	0	1	2
/datadrive/data/ESAdocs/federal_register/fr4499.pdf	0	0	0	0	2	0	0	2	2
/datadrive/data/ESAdocs/federal_register/fr449.pdf	0	0	0	0	1	0	0	1	5
/datadrive/data/ESAdocs/federal_register/fr4501.pdf	0	0	0	0	2	0	0	2	2
/datadrive/data/ESAdocs/federal_register/fr4503.pdf	0	0	0	0	2	0	0	2	2
/datadrive/data/ESAdocs/federal_register/fr4504.pdf	0	0	0	0	2	0	0	2	2
/datadrive/data/ESAdocs/federal_register/fr4505.pdf	0	0	0	0	4	0	0	4	6
/datadrive/data/ESAdocs/federal_register/fr4507.pdf	0	0	1	0	15	0	0	16	32
/datadrive/data/ESAdocs/federal_register/fr4508.pdf	0	0	0	0	1	0	0	1	2
/datadrive/data/ESAdocs/federal_register/fr450.pdf	0	0	0	0	2	0	0	2	4
/datadrive/data/ESAdocs/federal_register/fr4510.pdf	0	0	0	0	11	4	0	15	14
/datadrive/data/ESAdocs/federal_register/fr4511.pdf	21	7	5	0	23	0	0	56	28
/datadrive/data/ESAdocs/federal_register/fr4512.pdf	0	0	0	0	1	0	0	1	1
/datadrive/data/ESAdocs/federal_register/fr4514.pdf	1	0	0	0	2	0	0	3	2
/datadrive/data/ESAdocs/federal_register/fr4515.pdf	0	0	0	1	1	0	0	2	2
/datadrive/data/ESAdocs/federal_register/fr451.pdf	0	0	0	0	5	0	0	5	5
/datadrive/data/ESAdocs/federal_register/fr457.pdf	1	1	1	0	3	0	0	6	4
/datadrive/data/ESAdocs/federal_register/fr460.pdf	12	5	11	6	13	0	0	47	13
/datadrive/data/ESAdocs/federal_register/fr465.pdf	0	0	0	0	3	0	0	3	3
/datadrive/data/ESAdocs/federal_register/fr466.pdf	0	0	0	0	2	0	0	2	3
/datadrive/data/ESAdocs/federal_register/fr467.pdf	0	0	3	0	2	0	0	5	4
/datadrive/data/ESAdocs/federal_register/fr46.pdf	1	0	0	0	2	0	0	3	2
/datadrive/data/ESAdocs/federal_register/fr471.pdf	0	0	0	0	4	0	0	4	6
/datadrive/data/ESAdocs/federal_register/fr476.pdf	0	0	0	0	8	0	0	8	9
/datadrive/data/ESAdocs/federal_register/fr480.pdf	0	0	0	0	1	0	0	1	1
/datadrive/data/ESAdocs/federal_register/fr483.pdf	0	0	0	0	1	0	0	1	2
/datadrive/data/ESAdocs/federal_register/fr485.pdf	0	0	1	0	3	0	0	4	3
/datadrive/data/ESAdocs/federal_register/fr486.pdf	0	0	0	0	1	1	0	2	4
/datadrive/data/ESAdocs/federal_register/fr487.pdf	0	0	0	3	3	0	0	6	4
/datadrive/data/ESAdocs/federal_register/fr48.pdf	0	0	0	0	50	0	0	50	103
/datadrive/data/ESAdocs/federal_register/fr490.pdf	0	0	0	0	2	0	0	2	4
/datadrive/data/ESAdocs/federal_register/fr492.pdf	1	0	0	0	3	0	0	4	4
/datadrive/data/ESAdocs/federal_register/fr495.pdf	0	0	0	0	1	0	0	1	3
/datadrive/data/ESAdocs/federal_register/fr497.pdf	0	0	0	0	3	0	0	3	3
/datadrive/data/ESAdocs/federal_register/fr498.pdf	0	0	0	0	4	0	0	4	4
/datadrive/data/ESAdocs/federal_register/fr49.pdf	0	0	0	0	0	0	0	0	1
/datadrive/data/ESAdocs/federal_register/fr4.pdf	0	0	0	0	6	0	0	6	6
/datadrive/data/ESAdocs/federal_register/fr5000.pdf	0	0	0	0	1	0	0	1	2
/datadrive/data/ESAdocs/federal_register/fr5002.pdf	0	0	1	0	3	0	0	4	3
/datadrive/data/ESAdocs/federal_register/fr5003.pdf	0	0	0	0	2	0	0	2	2
/datadrive/data/ESAdocs/federal_register/fr501.pdf	0	0	0	0	3	0	0	3	3
/datadrive/data/ESAdocs/federal_register/fr5020.pdf	4	1	0	0	6	0	0	11	7
/datadrive/data/ESAdocs/federal_register/fr5021.pdf	6	1	0	0	10	0	0	17	10
/datadrive/data/ESAdocs/federal_register/fr5040.pdf	0	0	0	0	2	0	0	2	2
/datadrive/data/ESAdocs/federal_register/fr5041.pdf	0	0	0	0	2	0	0	2	2
/datadrive/data/ESAdocs/federal_register/fr5045.pdf	0	1	0	1	1	0	0	3	5
/datadrive/data/ESAdocs/federal_register/fr5047.pdf	0	0	0	0	3	0	0	3	5
/datadrive/data/ESAdocs/federal_register/fr5048.pdf	2	0	4	1	20	1	0	28	38
/datadrive/data/ESAdocs/federal_register/fr5060.pdf	1	0	1	0	1	0	0	3	1
/datadrive/data/ESAdocs/federal_register/fr5061.pdf	12	1	1	1	26	0	2	43	30
/datadrive/data/ESAdocs/federal_register/fr5062.pdf	0	0	0	0	1	0	0	1	2
/datadrive/data/ESAdocs/federal_register/fr5063.pdf	0	0	0	0	2	0	0	2	2
/datadrive/data/ESAdocs/federal_register/fr5065.pdf	0	0	0	0	3	0	0	3	3
/datadrive/data/ESAdocs/federal_register/fr5066.pdf	0	0	0	0	1	0	0	1	2
/datadrive/data/ESAdocs/federal_register/fr5068.pdf	0	0	0	0	9	0	0	9	12
/datadrive/data/ESAdocs/federal_register/fr5072.pdf	0	0	0	0	1	0	0	1	2
/datadrive/data/ESAdocs/federal_register/fr5073.pdf	5	0	0	1	10	3	2	21	11
/datadrive/data/ESAdocs/federal_register/fr5074.pdf	2	0	0	0	6	2	0	10	6
/datadrive/data/ESAdocs/federal_register/fr5076.pdf	0	2	7	3	11	0	0	23	18
/datadrive/data/ESAdocs/federal_register/fr5079.pdf	0	0	0	0	2	0	0	2	2
/datadrive/data/ESAdocs/federal_register/fr5080.pdf	0	0	0	0	2	0	0	2	5
/datadrive/data/ESAdocs/federal_register/fr5081.pdf	0	0	0	0	1	0	0	1	4
/datadrive/data/ESAdocs/federal_register/fr510.pdf	0	0	0	0	5	0	0	5	5
/datadrive/data/ESAdocs/federal_register/fr511.pdf	0	0	0	2	2	0	0	4	3
/datadrive/data/ESAdocs/federal_register/fr512.pdf	0	0	0	0	1	0	0	1	1
/datadrive/data/ESAdocs/federal_register/fr5137.pdf	1	2	1	1	22	3	2	32	44
/datadrive/data/ESAdocs/federal_register/fr5149.pdf	9	0	5	0	34	5	8	61	40
/datadrive/data/ESAdocs/federal_register/fr515.pdf	0	0	2	2	3	0	0	7	4
/datadrive/data/ESAdocs/federal_register/fr517.pdf	0	0	0	2	4	0	0	6	4
/datadrive/data/ESAdocs/federal_register/fr521.pdf	0	0	0	0	0	0	0	0	1
/datadrive/data/ESAdocs/federal_register/fr5253.pdf	0	0	0	0	0	0	0	0	101
/datadrive/data/ESAdocs/federal_register/fr52.pdf	1	0	0	0	1	0	0	2	2
/datadrive/data/ESAdocs/federal_register/fr5349.pdf	0	0	0	0	0	0	0	0	1
/datadrive/data/ESAdocs/federal_register/fr5350.pdf	0	0	0	0	0	0	0	0	2
/datadrive/data/ESAdocs/federal_register/fr537.pdf	0	0	0	0	4	1	0	5	5
/datadrive/data/ESAdocs/federal_register/fr538.pdf	0	2	2	0	5	0	0	9	6
/datadrive/data/ESAdocs/federal_register/fr549.pdf	0	0	0	0	5	1	0	6	6
/datadrive/data/ESAdocs/federal_register/fr574.pdf	0	0	0	0	0	1	0	1	3
/datadrive/data/ESAdocs/federal_register/fr58.pdf	0	0	0	0	3	0	0	3	4
/datadrive/data/ESAdocs/federal_register/fr591.pdf	0	0	0	0	0	0	0	0	4
/datadrive/data/ESAdocs/federal_register/fr599.pdf	0	0	0	0	2	0	0	2	4
/datadrive/data/ESAdocs/federal_register/fr5.pdf	0	0	0	0	2	0	0	2	2
/datadrive/data/ESAdocs/federal_register/fr609.pdf	1	0	1	0	2	0	0	4	3
/datadrive/data/ESAdocs/federal_register/fr60.pdf	0	0	0	0	1	0	0	1	1
/datadrive/data/ESAdocs/federal_register/fr617.pdf	0	0	0	1	3	0	0	4	4
/datadrive/data/ESAdocs/federal_register/fr618.pdf	0	0	0	0	3	0	0	3	4
/datadrive/data/ESAdocs/federal_register/fr61.pdf	0	0	0	0	1	0	0	1	1
/datadrive/data/ESAdocs/federal_register/fr620.pdf	0	0	2	3	3	0	1	9	4
/datadrive/data/ESAdocs/federal_register/fr621.pdf	0	0	0	0	4	0	0	4	5
/datadrive/data/ESAdocs/federal_register/fr626.pdf	0	0	0	0	4	0	0	4	5
/datadrive/data/ESAdocs/federal_register/fr630.pdf	0	0	0	0	1	0	0	1	1
/datadrive/data/ESAdocs/federal_register/fr633.pdf	0	0	0	0	1	0	0	1	3
/datadrive/data/ESAdocs/federal_register/fr635.pdf	0	0	1	0	5	0	1	7	7
/datadrive/data/ESAdocs/federal_register/fr638.pdf	0	0	0	0	3	0	0	3	4
/datadrive/data/ESAdocs/federal_register/fr63.pdf	0	0	0	0	9	0	0	9	9
/datadrive/data/ESAdocs/federal_register/fr641.pdf	1	0	0	0	3	0	0	4	6
/datadrive/data/ESAdocs/federal_register/fr644.pdf	0	0	0	1	1	0	0	2	4
/datadrive/data/ESAdocs/federal_register/fr64.pdf	1	0	0	0	2	0	0	3	2
/datadrive/data/ESAdocs/federal_register/fr650.pdf	0	0	0	0	3	0	0	3	7
/datadrive/data/ESAdocs/federal_register/fr652.pdf	0	0	1	0	2	0	0	3	3
/datadrive/data/ESAdocs/federal_register/fr655.pdf	0	0	0	0	4	0	0	4	5
/datadrive/data/ESAdocs/federal_register/fr65.pdf	0	0	0	0	1	0	0	1	3
/datadrive/data/ESAdocs/federal_register/fr660.pdf	0	0	0	0	1	0	0	1	3
/datadrive/data/ESAdocs/federal_register/fr667.pdf	0	0	0	0	2	0	0	2	2
/datadrive/data/ESAdocs/federal_register/fr670.pdf	0	0	0	0	2	0	0	2	3
/datadrive/data/ESAdocs/federal_register/fr681.pdf	0	0	0	0	3	0	0	3	4
/datadrive/data/ESAdocs/federal_register/fr6.pdf	0	0	0	0	2	0	0	2	3
/datadrive/data/ESAdocs/federal_register/fr701.pdf	0	0	0	0	1	0	0	1	2
/datadrive/data/ESAdocs/federal_register/fr703.pdf	0	0	0	0	4	0	0	4	5
/datadrive/data/ESAdocs/federal_register/fr704.pdf	0	0	0	1	3	0	0	4	4
/datadrive/data/ESAdocs/federal_register/fr70.pdf	0	0	0	0	1	0	0	1	3
/datadrive/data/ESAdocs/federal_register/fr712.pdf	1	0	2	0	3	0	0	6	3
/datadrive/data/ESAdocs/federal_register/fr713.pdf	0	0	1	0	1	0	0	2	4
/datadrive/data/ESAdocs/federal_register/fr714.pdf	1	0	1	1	2	0	0	5	2
/datadrive/data/ESAdocs/federal_register/fr715.pdf	1	0	1	0	4	0	0	6	8
/datadrive/data/ESAdocs/federal_register/fr719.pdf	0	0	0	0	2	0	0	2	3
/datadrive/data/ESAdocs/federal_register/fr71.pdf	0	0	1	0	2	0	0	3	5
/datadrive/data/ESAdocs/federal_register/fr721.pdf	0	0	0	0	3	0	0	3	4
/datadrive/data/ESAdocs/federal_register/fr728.pdf	8	1	2	0	11	0	0	22	11
/datadrive/data/ESAdocs/federal_register/fr72.pdf	1	0	0	0	12	0	0	13	18
/datadrive/data/ESAdocs/federal_register/fr732.pdf	0	0	0	0	3	0	0	3	4
/datadrive/data/ESAdocs/federal_register/fr734.pdf	0	0	0	0	1	0	0	1	4
/datadrive/data/ESAdocs/federal_register/fr736.pdf	0	0	1	0	4	0	0	5	9
/datadrive/data/ESAdocs/federal_register/fr739.pdf	3	0	1	3	3	0	0	10	5
/datadrive/data/ESAdocs/federal_register/fr73.pdf	0	0	0	0	1	0	0	1	1
/datadrive/data/ESAdocs/federal_register/fr741.pdf	2	0	2	0	3	0	0	7	4
/datadrive/data/ESAdocs/federal_register/fr743.pdf	0	0	0	0	1	0	0	1	4
/datadrive/data/ESAdocs/federal_register/fr74.pdf	0	0	0	0	2	0	0	2	2
/datadrive/data/ESAdocs/federal_register/fr750.pdf	2	0	0	0	5	0	0	7	5
/datadrive/data/ESAdocs/federal_register/fr751.pdf	0	0	2	0	2	0	0	4	3
/datadrive/data/ESAdocs/federal_register/fr752.pdf	0	0	0	2	5	0	0	7	5
/datadrive/data/ESAdocs/federal_register/fr753.pdf	1	0	0	0	4	0	0	5	5
/datadrive/data/ESAdocs/federal_register/fr755.pdf	0	0	0	0	1	2	0	3	6
/datadrive/data/ESAdocs/federal_register/fr756.pdf	0	0	2	1	4	0	0	7	9
/datadrive/data/ESAdocs/federal_register/fr760.pdf	0	0	0	0	3	0	0	3	5
/datadrive/data/ESAdocs/federal_register/fr769.pdf	2	0	0	0	4	0	0	6	4
/datadrive/data/ESAdocs/federal_register/fr76.pdf	0	0	0	0	0	0	0	0	1
/datadrive/data/ESAdocs/federal_register/fr770.pdf	0	0	0	0	4	0	1	5	5
/datadrive/data/ESAdocs/federal_register/fr772.pdf	0	0	0	1	4	0	0	5	5
/datadrive/data/ESAdocs/federal_register/fr774.pdf	0	0	0	0	4	0	0	4	5
/datadrive/data/ESAdocs/federal_register/fr775.pdf	0	0	0	0	3	0	0	3	4
/datadrive/data/ESAdocs/federal_register/fr778.pdf	0	0	0	0	0	0	0	0	1
/datadrive/data/ESAdocs/federal_register/fr784.pdf	0	0	0	0	1	0	0	1	1
/datadrive/data/ESAdocs/federal_register/fr785.pdf	0	0	0	0	2	0	0	2	3
/datadrive/data/ESAdocs/federal_register/fr787.pdf	0	0	0	0	2	0	0	2	4
/datadrive/data/ESAdocs/federal_register/fr788.pdf	1	0	0	0	1	0	0	2	5
/datadrive/data/ESAdocs/federal_register/fr789.pdf	0	0	0	0	2	0	0	2	4
/datadrive/data/ESAdocs/federal_register/fr790.pdf	0	0	0	0	2	0	1	3	3
/datadrive/data/ESAdocs/federal_register/fr794.pdf	0	0	0	0	4	0	0	4	6
/datadrive/data/ESAdocs/federal_register/fr797.pdf	0	0	0	1	3	0	0	4	4
/datadrive/data/ESAdocs/federal_register/fr798.pdf	0	0	0	0	2	0	0	2	5
/datadrive/data/ESAdocs/federal_register/fr800.pdf	0	0	0	0	2	0	0	2	4
/datadrive/data/ESAdocs/federal_register/fr801.pdf	0	0	0	0	4	0	0	4	5
/datadrive/data/ESAdocs/federal_register/fr805.pdf	0	0	0	0	1	0	0	1	4
/datadrive/data/ESAdocs/federal_register/fr809.pdf	0	0	0	0	1	0	0	1	2
/datadrive/data/ESAdocs/federal_register/fr811.pdf	0	0	0	0	3	0	0	3	3
/datadrive/data/ESAdocs/federal_register/fr814.pdf	0	0	0	0	2	0	0	2	3
/datadrive/data/ESAdocs/federal_register/fr815.pdf	2	1	0	1	2	0	0	6	5
/datadrive/data/ESAdocs/federal_register/fr817.pdf	0	0	0	0	0	0	0	0	4
/datadrive/data/ESAdocs/federal_register/fr819.pdf	0	0	0	0	6	3	0	9	8
/datadrive/data/ESAdocs/federal_register/fr820.pdf	0	0	3	3	4	1	0	11	5
/datadrive/data/ESAdocs/federal_register/fr822.pdf	0	0	0	0	2	0	0	2	4
/datadrive/data/ESAdocs/federal_register/fr825.pdf	0	0	0	0	1	0	0	1	3
/datadrive/data/ESAdocs/federal_register/fr827.pdf	0	0	0	0	3	0	0	3	4
/datadrive/data/ESAdocs/federal_register/fr828.pdf	2	0	0	0	4	0	0	6	5
/datadrive/data/ESAdocs/federal_register/fr830.pdf	4	0	0	3	3	0	0	10	5
/datadrive/data/ESAdocs/federal_register/fr831.pdf	0	0	0	0	4	0	0	4	6
/datadrive/data/ESAdocs/federal_register/fr834.pdf	0	0	0	0	2	0	0	2	2
/datadrive/data/ESAdocs/federal_register/fr835.pdf	1	0	0	0	3	0	1	5	4
/datadrive/data/ESAdocs/federal_register/fr836.pdf	0	0	0	0	4	0	0	4	12
/datadrive/data/ESAdocs/federal_register/fr837.pdf	0	0	1	0	4	0	0	5	4
/datadrive/data/ESAdocs/federal_register/fr838.pdf	1	0	1	0	5	0	0	7	5
/datadrive/data/ESAdocs/federal_register/fr839.pdf	0	0	3	2	2	0	0	7	4
/datadrive/data/ESAdocs/federal_register/fr83.pdf	0	0	0	0	3	0	0	3	5
/datadrive/data/ESAdocs/federal_register/fr840.pdf	0	0	1	0	3	0	0	4	5
/datadrive/data/ESAdocs/federal_register/fr841.pdf	0	0	0	0	2	0	0	2	4
/datadrive/data/ESAdocs/federal_register/fr842.pdf	0	0	0	0	2	0	0	2	4
/datadrive/data/ESAdocs/federal_register/fr843.pdf	2	0	0	1	3	0	0	6	4
/datadrive/data/ESAdocs/federal_register/fr844.pdf	1	0	0	0	5	0	0	6	8
/datadrive/data/ESAdocs/federal_register/fr846.pdf	0	0	0	0	7	0	0	7	11
/datadrive/data/ESAdocs/federal_register/fr848.pdf	0	0	2	0	1	0	0	3	4
/datadrive/data/ESAdocs/federal_register/fr849.pdf	0	0	0	1	1	0	0	2	4
/datadrive/data/ESAdocs/federal_register/fr851.pdf	0	0	0	0	4	0	0	4	7
/datadrive/data/ESAdocs/federal_register/fr852.pdf	0	1	0	0	4	0	0	5	5
/datadrive/data/ESAdocs/federal_register/fr853.pdf	0	0	0	0	5	0	1	6	6
/datadrive/data/ESAdocs/federal_register/fr854.pdf	0	0	0	0	2	0	0	2	5
/datadrive/data/ESAdocs/federal_register/fr856.pdf	0	0	0	2	3	0	0	5	4
/datadrive/data/ESAdocs/federal_register/fr857.pdf	0	0	0	0	7	0	1	8	9
/datadrive/data/ESAdocs/federal_register/fr858.pdf	0	0	0	0	2	0	0	2	4
/datadrive/data/ESAdocs/federal_register/fr859.pdf	0	0	0	0	2	0	0	2	3
/datadrive/data/ESAdocs/federal_register/fr860.pdf	0	0	0	0	2	0	0	2	3
/datadrive/data/ESAdocs/federal_register/fr861.pdf	0	0	0	0	2	0	0	2	4
/datadrive/data/ESAdocs/federal_register/fr862.pdf	0	0	0	2	1	0	0	3	4
/datadrive/data/ESAdocs/federal_register/fr863.pdf	0	0	0	0	1	0	0	1	4
/datadrive/data/ESAdocs/federal_register/fr865.pdf	1	0	2	2	3	0	0	8	3
/datadrive/data/ESAdocs/federal_register/fr875.pdf	0	0	0	0	3	0	0	3	5
/datadrive/data/ESAdocs/federal_register/fr878.pdf	0	0	0	0	3	2	0	5	5
/datadrive/data/ESAdocs/federal_register/fr879.pdf	0	0	2	0	5	0	0	7	8
/datadrive/data/ESAdocs/federal_register/fr880.pdf	0	0	1	0	3	0	0	4	4
/datadrive/data/ESAdocs/federal_register/fr881.pdf	0	0	0	0	1	0	0	1	4
/datadrive/data/ESAdocs/federal_register/fr882.pdf	0	0	0	0	2	0	0	2	7
/datadrive/data/ESAdocs/federal_register/fr883.pdf	0	0	0	1	1	0	0	2	4
/datadrive/data/ESAdocs/federal_register/fr885.pdf	0	0	2	0	2	0	0	4	3
/datadrive/data/ESAdocs/federal_register/fr890.pdf	0	0	0	0	4	0	1	5	5
/datadrive/data/ESAdocs/federal_register/fr892.pdf	0	0	0	0	2	0	1	3	5
/datadrive/data/ESAdocs/federal_register/fr893.pdf	0	0	0	0	1	0	0	1	6
/datadrive/data/ESAdocs/federal_register/fr895.pdf	4	0	2	4	4	0	0	14	5
/datadrive/data/ESAdocs/federal_register/fr897.pdf	1	0	0	0	3	0	0	4	5
/datadrive/data/ESAdocs/federal_register/fr898.pdf	0	0	0	3	3	1	1	8	4
/datadrive/data/ESAdocs/federal_register/fr899.pdf	0	0	0	0	2	0	0	2	5
/datadrive/data/ESAdocs/federal_register/fr8.pdf	0	0	0	1	3	0	0	4	4
/datadrive/data/ESAdocs/federal_register/fr900.pdf	0	0	0	0	2	0	0	2	4
/datadrive/data/ESAdocs/federal_register/fr902.pdf	1	0	0	1	3	0	0	5	4
/datadrive/data/ESAdocs/federal_register/fr903.pdf	3	0	2	0	4	0	0	9	5
/datadrive/data/ESAdocs/federal_register/fr906.pdf	0	0	0	0	1	0	0	1	2
/datadrive/data/ESAdocs/federal_register/fr910.pdf	0	0	0	0	3	0	0	3	5
/datadrive/data/ESAdocs/federal_register/fr913.pdf	0	0	0	0	0	0	0	0	1
/datadrive/data/ESAdocs/federal_register/fr915.pdf	0	0	0	0	3	0	1	4	8
/datadrive/data/ESAdocs/federal_register/fr916.pdf	1	0	1	1	3	0	0	6	5
/datadrive/data/ESAdocs/federal_register/fr918.pdf	3	0	0	0	5	0	0	8	5
/datadrive/data/ESAdocs/federal_register/fr922.pdf	0	0	0	0	0	0	0	0	4
/datadrive/data/ESAdocs/federal_register/fr923.pdf	0	0	0	1	4	0	0	5	5
/datadrive/data/ESAdocs/federal_register/fr925.pdf	1	0	1	1	2	0	0	5	4
/datadrive/data/ESAdocs/federal_register/fr926.pdf	1	1	1	1	2	0	0	6	4
/datadrive/data/ESAdocs/federal_register/fr927.pdf	0	0	0	0	4	0	0	4	4
/datadrive/data/ESAdocs/federal_register/fr928.pdf	0	1	1	1	2	0	0	5	4
/datadrive/data/ESAdocs/federal_register/fr929.pdf	0	0	0	0	1	0	0	1	3
/datadrive/data/ESAdocs/federal_register/fr933.pdf	1	0	0	0	3	0	0	4	5
/datadrive/data/ESAdocs/federal_register/fr934.pdf	0	0	0	0	0	0	0	0	5
/datadrive/data/ESAdocs/federal_register/fr935.pdf	0	0	0	3	2	0	0	5	4
/datadrive/data/ESAdocs/federal_register/fr936.pdf	1	0	0	0	1	0	0	2	4
/datadrive/data/ESAdocs/federal_register/fr938.pdf	0	0	0	0	1	0	0	1	5
/datadrive/data/ESAdocs/federal_register/fr940.pdf	0	0	0	0	0	0	0	0	2
/datadrive/data/ESAdocs/federal_register/fr941.pdf	0	0	0	0	0	0	0	0	4
/datadrive/data/ESAdocs/federal_register/fr942.pdf	1	0	1	1	2	0	0	5	3
/datadrive/data/ESAdocs/federal_register/fr944.pdf	0	0	0	0	2	0	0	2	3
/datadrive/data/ESAdocs/federal_register/fr945.pdf	2	0	0	0	4	0	0	6	8
/datadrive/data/ESAdocs/federal_register/fr946.pdf	3	1	0	2	3	0	0	9	5
/datadrive/data/ESAdocs/federal_register/fr947.pdf	1	0	0	0	5	0	0	6	5
/datadrive/data/ESAdocs/federal_register/fr949.pdf	0	0	0	0	1	0	0	1	3
/datadrive/data/ESAdocs/federal_register/fr950.pdf	0	0	0	0	1	0	0	1	4
/datadrive/data/ESAdocs/federal_register/fr952.pdf	0	0	2	3	9	0	0	14	18
/datadrive/data/ESAdocs/federal_register/fr954.pdf	0	0	0	0	4	0	0	4	5
/datadrive/data/ESAdocs/federal_register/fr956.pdf	2	0	0	0	6	1	0	9	9
/datadrive/data/ESAdocs/federal_register/fr957.pdf	0	0	0	0	6	1	0	7	9
/datadrive/data/ESAdocs/federal_register/fr95.pdf	1	0	0	0	5	0	0	6	5
/datadrive/data/ESAdocs/federal_register/fr960.pdf	0	0	0	0	14	0	1	15	18
/datadrive/data/ESAdocs/federal_register/fr964.pdf	0	0	0	0	4	3	0	7	6
/datadrive/data/ESAdocs/federal_register/fr968.pdf	0	0	0	0	6	4	0	10	8
/datadrive/data/ESAdocs/federal_register/fr969.pdf	0	0	0	0	6	2	1	9	9
/datadrive/data/ESAdocs/federal_register/fr96.pdf	1	0	0	1	5	1	0	8	7
/datadrive/data/ESAdocs/federal_register/fr970.pdf	0	0	0	0	4	0	0	4	7
/datadrive/data/ESAdocs/federal_register/fr973.pdf	0	2	0	0	5	0	0	7	5
/datadrive/data/ESAdocs/federal_register/fr974.pdf	0	0	0	0	2	0	1	3	4
/datadrive/data/ESAdocs/federal_register/fr975.pdf	0	0	0	0	2	0	0	2	4
/datadrive/data/ESAdocs/federal_register/fr976.pdf	0	0	0	0	0	0	0	0	2
/datadrive/data/ESAdocs/federal_register/fr979.pdf	1	0	1	0	3	0	0	5	4
/datadrive/data/ESAdocs/federal_register/fr980.pdf	0	0	0	0	2	0	0	2	4
/datadrive/data/ESAdocs/federal_register/fr981.pdf	0	0	1	0	3	0	0	4	3
/datadrive/data/ESAdocs/federal_register/fr982.pdf	0	0	0	0	2	0	0	2	4
/datadrive/data/ESAdocs/federal_register/fr984.pdf	0	0	0	0	0	0	0	0	2
/datadrive/data/ESAdocs/federal_register/fr985.pdf	0	0	0	2	2	0	0	4	3
/datadrive/data/ESAdocs/federal_register/fr986.pdf	0	0	0	2	3	1	1	7	4
/datadrive/data/ESAdocs/federal_register/fr987.pdf	0	0	0	0	1	0	0	1	5
/datadrive/data/ESAdocs/federal_register/fr990.pdf	0	0	0	0	6	0	0	6	7
/datadrive/data/ESAdocs/federal_register/fr993.pdf	1	0	0	1	2	0	0	4	4
/datadrive/data/ESAdocs/federal_register/fr994.pdf	0	0	0	0	3	0	0	3	6
/datadrive/data/ESAdocs/federal_register/fr995.pdf	1	0	0	0	7	0	1	9	8
/datadrive/data/ESAdocs/federal_register/fr996.pdf	0	0	1	0	2	0	0	3	4
/datadrive/data/ESAdocs/federal_register/fr997.pdf	0	1	2	0	2	0	0	5	4
/datadrive/data/ESAdocs/federal_register/fr999.pdf	0	0	0	0	2	0	0	2	4
/datadrive/data/ESAdocs/federal_register/fr99.pdf	0	0	0	0	4	0	0	4	4
